Zeit [anki:play:q:0]	Die Zeit , Die Zeiten Time [anki:play:a:0]
Man [anki:play:q:0]	Der Man ,Die Männer Man [anki:play:a:0]
Hand [anki:play:q:0]	Die Hand , Die Hände Hand [anki:play:a:0]
Tag [anki:play:q:0]	Der Tag , Die Tagen Day [anki:play:a:0]
Weg [anki:play:q:0]	Der Weg , Die Wege Way [anki:play:a:0]
Auge [anki:play:q:0]	Das Auge , Die Augen Eye [anki:play:a:0]
Ding [anki:play:q:0]	Das Ding , Die Dinge Thing [anki:play:a:0]
Kopf [anki:play:q:0]	Der Kopf , Die Köpfe Head [anki:play:a:0]
Jahr [anki:play:q:0]	Das Jahr , Die Jahre Year [anki:play:a:0]
Raum [anki:play:q:0]	Die Raum , Die Räume Room [anki:play:a:0]
Tür [anki:play:q:0]	Die Tür , Die Türen Door [anki:play:a:0]
Frau [anki:play:q:0]	Die Frau , Die Frauen Woman [anki:play:a:0]
Gesicht [anki:play:q:0]	Das Gesicht , Die Gesichter Face [anki:play:a:0]
Mutter [anki:play:q:0]	Die Mutter , Die Mütter Mother [anki:play:a:0]
Volk [anki:play:q:0]	Das Volk , Die Völker People [anki:play:a:0]
Nacht [anki:play:q:0]	Die Nacht , Die Nächte Night [anki:play:a:0]
Haus [anki:play:q:0]	Das Haus , Die Häuser House [anki:play:a:0]
Leben [anki:play:q:0]	Das Leben , Die Leben Life [anki:play:a:0]
Rücken [anki:play:q:0]	Der Rücken , Die Rücken Back [anki:play:a:0]
Stimme [anki:play:q:0]	Die Stimme , Die Stimmen Voice [anki:play:a:0]
Mädchen [anki:play:q:0]	Das Mädchen , Die Mädchen Girl [anki:play:a:0]
Ort [anki:play:q:0]	Der Ort , Die Orte Place [anki:play:a:0]
Junge [anki:play:q:0]	Der Junge , Die Jungen Boy [anki:play:a:0]
Auto [anki:play:q:0]	Das Auto , Die Autos Car [anki:play:a:0]
Arm [anki:play:q:0]	Der Arm , Die Arme Arm [anki:play:a:0]
Wort [anki:play:q:0]	Das Wort , Die Worte Word [anki:play:a:0]
Moment [anki:play:q:0]	Der Moment , Die Momente Moment [anki:play:a:0]
Haar [anki:play:q:0]	Das Haar , Die Haare Hair [anki:play:a:0]
Fuß [anki:play:q:0]	Der Fuß , Die Füße Foot [anki:play:a:0]
Wasser [anki:play:q:0]	Das Wasser , Die Wasser Water [anki:play:a:0]
Licht [anki:play:q:0]	Das Licht , Die Lichter Light [anki:play:a:0]
Welt [anki:play:q:0]	Die Welt , Die Welt World [anki:play:a:0]
Name [anki:play:q:0]	Der Name , Die Namen Name [anki:play:a:0]
Fenster [anki:play:q:0]	Das Fenster , Die Fenster Window [anki:play:a:0]
Körper [anki:play:q:0]	Der Körper , Die Körper Body [anki:play:a:0]
Tisch [anki:play:q:0]	Der Tisch , die Tische Table [anki:play:a:0]
Morgen [anki:play:q:0]	Der Morgen , Die Morgen Morning [anki:play:a:0]
Bett [anki:play:q:0]	Das Bett , Die Betten Bed [anki:play:a:0]
Mauer [anki:play:q:0]	Die Mauer ,die Mauern Wall [anki:play:a:0]
Straße [anki:play:q:0]	Die Straße , Die Straßen Street [anki:play:a:0]
Schule [anki:play:q:0]	Die Schule , Die Schulen School [anki:play:a:0]
Luft [anki:play:q:0]	Die Luft , Die Lüfte Air [anki:play:a:0]
Boden [anki:play:q:0]	Der Boden , Die Böden Floor, Bottom [anki:play:a:0]
Stunde [anki:play:q:0]	Die Stunde , Die Stunden Hour [anki:play:a:0]
Ende [anki:play:q:0]	Das Ende , Die Enden End [anki:play:a:0]
Familie [anki:play:q:0]	Die Familie , Die Familien Family [anki:play:a:0]
Kerl [anki:play:q:0]	Der Kerl , Die Kerle Guy [anki:play:a:0]
Art [anki:play:q:0]	Die Art , Die Arten Kind [anki:play:a:0]
Minute [anki:play:q:0]	Die Minute , Die Minuten Minute [anki:play:a:0]
Geschichte [anki:play:q:0]	Die Geschichte , Die Geschichten Story [anki:play:a:0]
Gott [anki:play:q:0]	Der Gott , Die Götter God [anki:play:a:0]
Woche [anki:play:q:0]	Die Woche , Die Wochen Week [anki:play:a:0]
Arbeit [anki:play:q:0]	Die Arbeit , die Arbeiten Work [anki:play:a:0]
Schulter [anki:play:q:0]	Die Schulter , Die Schultern Shoulder [anki:play:a:0]
Teil [anki:play:q:0]	Der Teil , Die Teile Part [anki:play:a:0]
Geist [anki:play:q:0]	Der Geist Mind [anki:play:a:0]
Buch [anki:play:q:0]	Das Buch , Die Bücher Book [anki:play:a:0]
Finger [anki:play:q:0]	Der Finger , Die Finger Finger [anki:play:a:0]
Mund [anki:play:q:0]	Der Mund, die Münde Mouth [anki:play:a:0]
Kind [anki:play:q:0]	Das Kind , Die Kinder Kid [anki:play:a:0]
Glas [anki:play:q:0]	Das Glas , die Gläser Glass [anki:play:a:0]
Baum [anki:play:q:0]	Der Baum , Die Bäume Tree [anki:play:a:0]
Klang [anki:play:q:0]	Der Klang , Die Kläng Sound [anki:play:a:0]
Linie [anki:play:q:0]	Die Linie , Die Linien Line [anki:play:a:0]
Ehefrau [anki:play:q:0]	Die Ehefrau , Die Ehefrauen Wife [anki:play:a:0]
Herz [anki:play:q:0]	Das Herz , Die Herzen Heart [anki:play:a:0]
Geld [anki:play:q:0]	Das Geld , Die Gelder Money [anki:play:a:0]
Telefon [anki:play:q:0]	Das Telefon , Die Telefone Phone [anki:play:a:0]
Blick [anki:play:q:0]	der Blick, Die Blicke Look [anki:play:a:0]
Bein [anki:play:q:0]	Das Bein , Die Beine Leg [anki:play:a:0]
Stuhl [anki:play:q:0]	Der Stuhl , Die Stühle Chair [anki:play:a:0]
Büro [anki:play:q:0]	Das Büro , Die Büros Office [anki:play:a:0]
Bruder [anki:play:q:0]	Der Bruder , Die Brüder Brother [anki:play:a:0]
Frage [anki:play:q:0]	Die Frage , Die Fragen Question [anki:play:a:0]
Stadt [anki:play:q:0]	Die Stadt , Die Städte City [anki:play:a:0]
Monat [anki:play:q:0]	Der Monat , Die Monate Month [anki:play:a:0]
Baby [anki:play:q:0]	Das Baby , Die Babys Baby [anki:play:a:0]
Hund [anki:play:q:0]	Der Hund , Die Hunde Dog [anki:play:a:0]
Idee [anki:play:q:0]	Die Idee , Die Ideen Idea [anki:play:a:0]
Küche [anki:play:q:0]	Die Küche , Die Küchen Kitchen [anki:play:a:0]
Los [anki:play:q:0]	Das Los , Die Lose Lot [anki:play:a:0]
Sohn [anki:play:q:0]	Der Sohn , Die Söhne Son [anki:play:a:0]
Beruf [anki:play:q:0]	Der Beruf Job [anki:play:a:0]
Papier [anki:play:q:0]	Das Papier , Die Papiere Paper [anki:play:a:0]
Schwester [anki:play:q:0]	Die Schwester , Die Schwestern Sister [anki:play:a:0]
Lächeln [anki:play:q:0]	Das Lächeln , Die Lächeln Smile [anki:play:a:0]
Punkt [anki:play:q:0]	Der Punkt , Die Punkte Point [anki:play:a:0]
Gedanke [anki:play:q:0]	Der Gedanke , Die Gedanken Thought [anki:play:a:0]
Liebe [anki:play:q:0]	Die Liebe , Die Liebe Love [anki:play:a:0]
Tod [anki:play:q:0]	Der Tod , die Tode Death [anki:play:a:0]
Feuer [anki:play:q:0]	Das Feuer , Die Feuer Fire [anki:play:a:0]
Schritt [anki:play:q:0]	Der Schritt , Die Schritte Step [anki:play:a:0]
Blut [anki:play:q:0]	Das Blut , Die Blut Blood [anki:play:a:0]
Tatsache [anki:play:q:0]	Die Tatsache , die Tatsachen Fact [anki:play:a:0]
Atem [anki:play:q:0]	Der Atem , Die Atem Breath [anki:play:a:0]
Lippe [anki:play:q:0]	Die Lippe , Die Lippen Lip [anki:play:a:0]
Sonne [anki:play:q:0]	Die Sonne , Die Sonnen Sun [anki:play:a:0]
Gebäude [anki:play:q:0]	das Gebäude , Die Gebäude Building [anki:play:a:0]
Anzahl [anki:play:q:0]	Die Anzahl , die Anzahlen Number [anki:play:a:0]
Ehemann [anki:play:q:0]	Der Ehemann , Die Ehemänner Husband [anki:play:a:0]
Eltern [anki:play:q:0]	Das Eltern, Die Eltern Parent [anki:play:a:0]
Ecke [anki:play:q:0]	Die Ecke , Die Ecken Corner [anki:play:a:0]
Problem [anki:play:q:0]	Das Problem , Die Probleme Problem [anki:play:a:0]
Ehepaar [anki:play:q:0]	Das Ehepaar , Die Paare Couple [anki:play:a:0]
Tochter [anki:play:q:0]	Die Tochter , Die Töchter Daughter [anki:play:a:0]
Hölle [anki:play:q:0]	Die Hölle , Die Höllen Hell [anki:play:a:0]
Rest [anki:play:q:0]	Die Rest , Die Reste Rest [anki:play:a:0]
Geschäft [anki:play:q:0]	Das Geschäft , die Geschäfte Business [anki:play:a:0]
Himmel [anki:play:q:0]	Der Himmel , Der Himmel Sky [anki:play:a:0]
Kiste [anki:play:q:0]	Die Kiste , die Kisten Box [anki:play:a:0]
Person [anki:play:q:0]	Die Person , Die Personen Person [anki:play:a:0]
Grund [anki:play:q:0]	Der Grund , Die Gründe Reason [anki:play:a:0]
Recht [anki:play:q:0]	Das Recht , Die Rechte Right [anki:play:a:0]
Haut [anki:play:q:0]	Die Haut , Die Häute Skin [anki:play:a:0]
Vater [anki:play:q:0]	Der Vater , Die Väter Dad [anki:play:a:0]
Fall [anki:play:q:0]	Der Fall , Die Fälle Case [anki:play:a:0]
Stück [anki:play:q:0]	Das Stück , Die Stücke Piece [anki:play:a:0]
Doktor [anki:play:q:0]	Der Doktor , Die Doktoren Doctor [anki:play:a:0]
Bild [anki:play:q:0]	Das Bild , Die Bilder Picture [anki:play:a:0]
Sinn [anki:play:q:0]	Der Sinn , Die Sinne Sense [anki:play:a:0]
Ohr [anki:play:q:0]	Das Ohr , Die Ohren Ear [anki:play:a:0]
Zweite [anki:play:q:0]	Der Zweite , die Zweiten Second [anki:play:a:0]
Dame [anki:play:q:0]	Die Dame , Die Damen Lady [anki:play:a:0]
Hals [anki:play:q:0]	Der Hals , Die Hälse Neck [anki:play:a:0]
Wind [anki:play:q:0]	Der Wind , Die Winde Wind [anki:play:a:0]
Schreibtisch [anki:play:q:0]	Der Schreibtisch , Die Schreibtische Desk [anki:play:a:0]
Waffe [anki:play:q:0]	Die Waffe , Die Waffen Gun [anki:play:a:0]
Stein [anki:play:q:0]	Der Stein , Die Steine Stone [anki:play:a:0]
Kaffee [anki:play:q:0]	Der Kaffee , Die Kaffee Coffee [anki:play:a:0]
Schiff [anki:play:q:0]	Das Schiff , Die Schiffe Ship [anki:play:a:0]
Erde [anki:play:q:0]	Die Erde , Die Erden Earth [anki:play:a:0]
Essen [anki:play:q:0]	Das Essen , die Essen Food [anki:play:a:0]
Pferd [anki:play:q:0]	Das Pferd , Die Pferde Horse [anki:play:a:0]
Feld [anki:play:q:0]	Das Feld , Die Felder Field [anki:play:a:0]
Krieg [anki:play:q:0]	Der Krieg , Die Kriege War [anki:play:a:0]
Nachmittag [anki:play:q:0]	Der Nachmittag , Die Nachmittage Afternoon [anki:play:a:0]
Abend [anki:play:q:0]	Der Abend , Die Abende Evening [anki:play:a:0]
Brief [anki:play:q:0]	Der Brief , Die Briefe Letter [anki:play:a:0]
Bar [anki:play:q:0]	Die Bar , Die Bars Bar [anki:play:a:0]
Traum [anki:play:q:0]	Der Traum , Die Träume Dream [anki:play:a:0]
Wohnung [anki:play:q:0]	Die Wohnung , Die Wohnungen Apartment [anki:play:a:0]
Brust [anki:play:q:0]	Die Brust , die Brüste Chest [anki:play:a:0]
Spiel [anki:play:q:0]	Das Spiel , Die Spiele Game [anki:play:a:0]
Sommer [anki:play:q:0]	Der Sommer , Die Sommer Summer [anki:play:a:0]
Stille [anki:play:q:0]	Die Stille , Die Stille Silence [anki:play:a:0]
Spitze [anki:play:q:0]	Die Spitze , Die Spitzen o topo, ou a ponta [anki:play:a:0]
Fels [anki:play:q:0]	Der Fels , die Felsen Rock [anki:play:a:0]
Macht [anki:play:q:0]	Die Macht , die Mächte Power [anki:play:a:0]
Kleid [anki:play:q:0]	Das Kleid, Die Kleider Clothes, roupas [anki:play:a:0]
Schild [anki:play:q:0]	Das Schild , die Schilde Sign [anki:play:a:0]
Aufmerksamkeit [anki:play:q:0]	Die Aufmerksamkeit , Die Aufmerksamkeiten Attention [anki:play:a:0]
Musik [anki:play:q:0]	Die Musik , Die Musiken Music [anki:play:a:0]
Staat [anki:play:q:0]	Der Staat , Die Staaten State [anki:play:a:0]
Tasche [anki:play:q:0]	Die Tasche , Die Taschen Pocket [anki:play:a:0]
Abendessen [anki:play:q:0]	Das Abendessen , Die Abendessen Dinner [anki:play:a:0]
Halle [anki:play:q:0]	Die Halle , Die Hallen Hall [anki:play:a:0]
Schmerz [anki:play:q:0]	Der Schmerz , Die Schmerzen Pain [anki:play:a:0]
Alter [anki:play:q:0]	Das Alter , Die Alter Age [anki:play:a:0]
Fluss [anki:play:q:0]	Der Fluss , Die Flüsse River [anki:play:a:0]
Chance [anki:play:q:0]	Die Chance, Die Chancen Chance [anki:play:a:0]
Nase [anki:play:q:0]	Die Nase , Die Nasen Nose [anki:play:a:0]
Schatten [anki:play:q:0]	Der Schatten , Die Schatten Shadow [anki:play:a:0]
Polizei [anki:play:q:0]	Die Polizei , die Polizeien Police [anki:play:a:0]
Gedächtnis [anki:play:q:0]	Das Gedächtnis , die Gedächtnisse Memory [anki:play:a:0]
Farbe [anki:play:q:0]	Die Farbe , Die Farben Color [anki:play:a:0]
Knie [anki:play:q:0]	Das Knie , Die Knie Knee [anki:play:a:0]
Holz [anki:play:q:0]	Das Holz , die Hölzer Wood [anki:play:a:0]
Hemd [anki:play:q:0]	Das Hemd , Die Hemden Shirt [anki:play:a:0]
Party [anki:play:q:0]	Die Party , Die Partys Party [anki:play:a:0]
Land [anki:play:q:0]	Das Land , Die Länder Country [anki:play:a:0]
Lkw [anki:play:q:0]	Der Lkw , die LKWs Truck [anki:play:a:0]
Zahn [anki:play:q:0]	Der Zahn , die Zähne Tooth [anki:play:a:0]
Rechnung [anki:play:q:0]	Die Rechnung , Die Rechnungen Bill [anki:play:a:0]
Szene [anki:play:q:0]	Die Szene , die Szenen Scene [anki:play:a:0]
Stern [anki:play:q:0]	Der Stern , Die Sterne Star [anki:play:a:0]
Vogel [anki:play:q:0]	Der Vogel , Die Vögel Bird [anki:play:a:0]
Onkel [anki:play:q:0]	Der Onkel , Die Onkel Uncle [anki:play:a:0]
Gruppe [anki:play:q:0]	Die Gruppe , Die Gruppen Group [anki:play:a:0]
Wahrheit [anki:play:q:0]	Die Wahrheit , Die Wahrheiten Truth [anki:play:a:0]
Schwierigkeit [anki:play:q:0]	Die Schwierigkeit , Die Schwierigkeiten Trouble [anki:play:a:0]
Menge [anki:play:q:0]	Die Menge , die Mengen Crowd [anki:play:a:0]
Bahnhof [anki:play:q:0]	Der Bahnhof ,die Bahnhöfe Station [anki:play:a:0]
Klasse [anki:play:q:0]	Die Klasse , Die Klassen Class [anki:play:a:0]
Meer [anki:play:q:0]	Das Meer , Die Meere Sea [anki:play:a:0]
Tier [anki:play:q:0]	Das Tier , Die Tiere Animal [anki:play:a:0]
Zentrum [anki:play:q:0]	Das Zentrum , Die Zentren Center [anki:play:a:0]
Gefühl [anki:play:q:0]	Das Gefühl , Die Gefühle Feeling [anki:play:a:0]
Berg [anki:play:q:0]	Der Berg , Die Berge Mountain [anki:play:a:0]
Nachricht [anki:play:q:0]	Die Nachricht , Die Nachrichten News [anki:play:a:0]
Schuh [anki:play:q:0]	Der Schuh , Die Schuhe Shoe [anki:play:a:0]
Katze [anki:play:q:0]	Die Katze , Die Katzen Cat [anki:play:a:0]
Schirm [anki:play:q:0]	Der Schirm , Die Schirme Screen [anki:play:a:0]
Flasche [anki:play:q:0]	Die Flasche , Die Flaschen Bottle [anki:play:a:0]
Anruf [anki:play:q:0]	Der Anruf , Die Anrufe Call [anki:play:a:0]
Lebenden [anki:play:q:0]	Die Lebenden Living [anki:play:a:0]
Wange [anki:play:q:0]	Die Wange , Die Wangen Cheek [anki:play:a:0]
Schüler [anki:play:q:0]	Der Schüler, Die Schüler Student [anki:play:a:0]
Ball [anki:play:q:0]	Der Ball , Die Bälle Ball [anki:play:a:0]
Sehenswürdigkeit [anki:play:q:0]	Die Sehenswürdigkeit , Die Sehenswürdigkeiten Sight [anki:play:a:0]
Hügel [anki:play:q:0]	Der Hügel , Die Hügel Hill [anki:play:a:0]
Unternehmen [anki:play:q:0]	Das Unternehmen , die Unternehmens Company [anki:play:a:0]
Kirche [anki:play:q:0]	Die Kirche , Die Kirchen Church [anki:play:a:0]
Regen [anki:play:q:0]	Der Regen , Die Regens Rain [anki:play:a:0]
Anzug [anki:play:q:0]	Der Anzug , Die Anzüge Suit [anki:play:a:0]
Eine [anki:play:q:0]	Der Eine , Die Einen One [anki:play:a:0]
Richtung [anki:play:q:0]	Die Richtung , Die Richtungen Direction [anki:play:a:0]
Wille [anki:play:q:0]	Der Wille , die Willen Will [anki:play:a:0]
Mitte [anki:play:q:0]	Die Mitte, Die Mitten Middle [anki:play:a:0]
Antwort [anki:play:q:0]	Die Antwort , Die Antworten Answer [anki:play:a:0]
Zeug [anki:play:q:0]	Das Zeug , Die Zeuge Stuff [anki:play:a:0]
Krankenhaus [anki:play:q:0]	Das Krankenhaus , Die Krankenhäuser Hospital [anki:play:a:0]
Kamera [anki:play:q:0]	Die Kamera , Die Kameras Camera [anki:play:a:0]
Karte [anki:play:q:0]	Die Karte , Die Karten Card [anki:play:a:0]
Hof [anki:play:q:0]	Der Hof , die Höfe Yard [anki:play:a:0]
Dunkelheit [anki:play:q:0]	Die Dunkelheit , Die Dunkelheiten Dark [anki:play:a:0]
Scheiße [anki:play:q:0]	Die Scheiße , Die Scheiße Shit [anki:play:a:0]
Maschine [anki:play:q:0]	Die Maschine , Die Maschinen Machine [anki:play:a:0]
Distanz [anki:play:q:0]	Die Distanz , Die Distanzen Distance [anki:play:a:0]
Gebiet [anki:play:q:0]	Das Gebiet , die Gebiete Area [anki:play:a:0]
Erzähler [anki:play:q:0]	Der Erzähler , Die Erzähler Narrator [anki:play:a:0]
Eis [anki:play:q:0]	Das Eis Ice [anki:play:a:0]
Schnee [anki:play:q:0]	Der Schnee Snow [anki:play:a:0]
Notiz [anki:play:q:0]	Die Notiz , Die Notizen Note [anki:play:a:0]
Spiegel [anki:play:q:0]	Der Spiegel , Die Spiegel Mirror [anki:play:a:0]
König [anki:play:q:0]	Der König , Die Könige King [anki:play:a:0]
Angst [anki:play:q:0]	Die Angst , Die Ängste Fear [anki:play:a:0]
Offizier [anki:play:q:0]	Der Offizier , Die Offiziere Officer [anki:play:a:0]
Loch [anki:play:q:0]	Das Loch , Die Löcher Hole [anki:play:a:0]
Schuss [anki:play:q:0]	Der Schuss , Die Schüsse Shot [anki:play:a:0]
Wächter [anki:play:q:0]	Der Wächter , die Wächter Guard [anki:play:a:0]
Boot [anki:play:q:0]	Das Boot , Die Boote Boat [anki:play:a:0]
System [anki:play:q:0]	Das System , Die Systeme System [anki:play:a:0]
Pflege [anki:play:q:0]	Die Pflege , die Pflegen Care [anki:play:a:0]
Bit [anki:play:q:0]	Die Bit , Die Bits Bit [anki:play:a:0]
Film [anki:play:q:0]	Der Film , die Filme Movie [anki:play:a:0]
Knochen [anki:play:q:0]	Der Knochen , Die Knochen Bone [anki:play:a:0]
Seite [anki:play:q:0]	Die Seite , Die Seiten Page [anki:play:a:0]
Kapitän [anki:play:q:0]	Der Kapitän , Die Kapitäne Captain [anki:play:a:0]
Tante [anki:play:q:0]	Die Tante , Die Tanten Aunt [anki:play:a:0]
Kontrolle [anki:play:q:0]	Die Kontrolle , Die Kontrollen Control [anki:play:a:0]
Getränk [anki:play:q:0]	Das Getränk , Die Getränke Drink [anki:play:a:0]
Hotel [anki:play:q:0]	Das Hotel , Die Hotels Hotel [anki:play:a:0]
Mantel [anki:play:q:0]	Der Mantel , Die Mäntel Coat [anki:play:a:0]
Treppe [anki:play:q:0]	Die Treppe , Die Treppen Stair [anki:play:a:0]
Bestellung [anki:play:q:0]	Die Bestellung , die Bestellungen Order [anki:play:a:0]
Rose [anki:play:q:0]	Die Rose , Die Rosen Rose [anki:play:a:0]
Hut [anki:play:q:0]	Der Hut , Die Hüte Hat [anki:play:a:0]
Gold [anki:play:q:0]	Das Gold Gold [anki:play:a:0]
Zigarette [anki:play:q:0]	Die Zigarette , Die Zigaretten Cigarette [anki:play:a:0]
Wolke [anki:play:q:0]	Die Wolke , Die Wolken Cloud [anki:play:a:0]
Tasse [anki:play:q:0]	Die Tasse , Die Tassen Cup [anki:play:a:0]
Figur [anki:play:q:0]	Die Figur , Die Figuren Figure [anki:play:a:0]
Ausdruck [anki:play:q:0]	Der Ausdruck , Die Ausdrücke Expression [anki:play:a:0]
Pfad [anki:play:q:0]	Der Pfad , Die Wege Path [anki:play:a:0]
Schlüssel [anki:play:q:0]	Der Schlüssel , Die Schlüssel Key [anki:play:a:0]
Computer [anki:play:q:0]	Der Computer , Die Computer Computer [anki:play:a:0]
Blume [anki:play:q:0]	Die Blume , Die Blumen Flower [anki:play:a:0]
Ring [anki:play:q:0]	Der Ring , Die Ringe Ring [anki:play:a:0]
Metall [anki:play:q:0]	Das Metall , Die Metalle Metal [anki:play:a:0]
Mond [anki:play:q:0]	Der Mond , Die Monde Moon [anki:play:a:0]
Lied [anki:play:q:0]	Das Lied , Die Lieder Song [anki:play:a:0]
Soldat [anki:play:q:0]	Der Soldat , Die Soldaten Soldier [anki:play:a:0]
Radio [anki:play:q:0]	Das Radio , Die Funkgeräte Radio [anki:play:a:0]
Welle [anki:play:q:0]	Die Welle , Die Wellen Wave [anki:play:a:0]
Plan [anki:play:q:0]	Der Plan , Die Pläne Plan [anki:play:a:0]
Fisch [anki:play:q:0]	Der Fisch , Die Fische Fish [anki:play:a:0]
Garten [anki:play:q:0]	Der Garten , Die Gärten Garden [anki:play:a:0]
Zug [anki:play:q:0]	Der Zug , Die Züge Train [anki:play:a:0]
Polizist [anki:play:q:0]	Der Polizist , Die Polizisten Cop [anki:play:a:0]
Kunst [anki:play:q:0]	Die Kunst , Die Künste Art [anki:play:a:0]
Bier [anki:play:q:0]	Das Bier , Die Biere Beer [anki:play:a:0]
Insel [anki:play:q:0]	Die Insel , Die Inseln Island [anki:play:a:0]
Bus [anki:play:q:0]	Der Bus , Die Busse Bus [anki:play:a:0]
Geruch [anki:play:q:0]	Der Geruch , Die Gerüche Smell [anki:play:a:0]
Geräusch [anki:play:q:0]	Das Geräusch , Die Geräusche Noise [anki:play:a:0]
Mama [anki:play:q:0]	Die Mama , The Mamas Mama [anki:play:a:0]
Park [anki:play:q:0]	Der Park , Die Parks Park [anki:play:a:0]
Süden [anki:play:q:0]	Der Süden , Die Souths South [anki:play:a:0]
Paar [anki:play:q:0]	Das Paar , Die Paare Pair [anki:play:a:0]
Herr [anki:play:q:0]	Der Herr , Die Herren Lord [anki:play:a:0]
Teller [anki:play:q:0]	Der Teller , Die Platten Plate [anki:play:a:0]
Jacke [anki:play:q:0]	Die Jacke , Die Jacken Jacket [anki:play:a:0]
Hilfe [anki:play:q:0]	Die Hilfe , Die Hilft Help [anki:play:a:0]
Papa [anki:play:q:0]	Der Papa , Die Väter Daddy [anki:play:a:0]
Gras [anki:play:q:0]	Das Gras , Die Gräser Grass [anki:play:a:0]
Dank [anki:play:q:0]	Die Dank , Die Thankses Thanks [anki:play:a:0]
Hitze [anki:play:q:0]	Die Hitze , Die Heats Heat [anki:play:a:0]
Schlaf [anki:play:q:0]	Der Schlaf , Die Schlafplätze Sleep [anki:play:a:0]
Gehirn [anki:play:q:0]	Das Gehirn , Die Gehirne Brain [anki:play:a:0]
Service [anki:play:q:0]	Der Service , Der Dienstleistungen Service [anki:play:a:0]
Reise [anki:play:q:0]	Die Reise , Die Reisen Trip [anki:play:a:0]
Beat [anki:play:q:0]	Der Beat , Die Beats Beat [anki:play:a:0]
Messer [anki:play:q:0]	Das Messer , Die Messer Knife [anki:play:a:0]
Platz [anki:play:q:0]	Der Platz , Die Flecken Spot [anki:play:a:0]
Note [anki:play:q:0]	Die Note , Die Noten Mark [anki:play:a:0]
Lehrer [anki:play:q:0]	Der Lehrer , Die Lehrer Teacher [anki:play:a:0]
Dorf [anki:play:q:0]	Das Dorf , Die Dörfer Village [anki:play:a:0]
Winter [anki:play:q:0]	Der Winter , Die Winter Winter [anki:play:a:0]
Front [anki:play:q:0]	Die Front , Die Fronten Front [anki:play:a:0]
Gesetz [anki:play:q:0]	Das Gesetz , Die Gesetze Law [anki:play:a:0]
Oberfläche [anki:play:q:0]	Die Oberfläche , Die Oberflächen Surface [anki:play:a:0]
Bank [anki:play:q:0]	Die Bank , Die Banken Bank [anki:play:a:0]
Team [anki:play:q:0]	Das Team , Die Teams Team [anki:play:a:0]
Maximum [anki:play:q:0]	Das Maximum , Die Maxima Maximum [anki:play:a:0]
Position [anki:play:q:0]	Die Position , Die Positionen Position [anki:play:a:0]
Bauch [anki:play:q:0]	Der Bauch , Die Mägen Stomach [anki:play:a:0]
Wende [anki:play:q:0]	Die Wende , Die Windungen Turn [anki:play:a:0]
Westen [anki:play:q:0]	Der Westen , Die Wests West [anki:play:a:0]
Mittagessen [anki:play:q:0]	Das Mittagessen , Die Mittagessen Lunch [anki:play:a:0]
Wechsel [anki:play:q:0]	Der Wechsel , Die Veränderungen Change [anki:play:a:0]
Kreatur [anki:play:q:0]	Die Kreatur , Geschöpfe Creature [anki:play:a:0]
Seele [anki:play:q:0]	Die Seele , Die Seelen Soul [anki:play:a:0]
Blatt [anki:play:q:0]	Das Blatt , Die Blätter Leaf [anki:play:a:0]
Show [anki:play:q:0]	Die Show , Die Shows Show [anki:play:a:0]
Gate [anki:play:q:0]	Die Gate , Die Tore Gate [anki:play:a:0]
Palme [anki:play:q:0]	Die Palme , Die Handflächen Palm [anki:play:a:0]
Kunststoff [anki:play:q:0]	Der Kunststoff , Die Kunststoff Plastic [anki:play:a:0]
Kraft [anki:play:q:0]	Die Kraft , Die Kräfte Force [anki:play:a:0]
Strand [anki:play:q:0]	Der Strand , Die Strände Beach [anki:play:a:0]
Präsident [anki:play:q:0]	Der Präsident , Die Präsidenten President [anki:play:a:0]
Form [anki:play:q:0]	Die Form , Die Formen Shape [anki:play:a:0]
Rauch [anki:play:q:0]	Der Rauch , Die Raucht Smoke [anki:play:a:0]
Rad [anki:play:q:0]	Das Rad , Die Räder Wheel [anki:play:a:0]
Silber [anki:play:q:0]	Das Silber , Die Silber Silver [anki:play:a:0]
Dach [anki:play:q:0]	Das Dach , Die Dächer Roof [anki:play:a:0]
Gewicht [anki:play:q:0]	Das Gewicht , Die Gewichte Weight [anki:play:a:0]
Zunge [anki:play:q:0]	Die Zunge , Die Zungen Tongue [anki:play:a:0]
Tee [anki:play:q:0]	Der Tee , Die Tees Tea [anki:play:a:0]
Strecke [anki:play:q:0]	Die Strecke , Die Spuren Track [anki:play:a:0]
Winkel [anki:play:q:0]	Der Winkel , Die Winkel Angle [anki:play:a:0]
Ton [anki:play:q:0]	Der Ton , Die Töne Tone [anki:play:a:0]
Kreis [anki:play:q:0]	Der Kreis , Die Kreise Circle [anki:play:a:0]
Frühling [anki:play:q:0]	Der Frühling , Die Federn Spring [anki:play:a:0]
Vorhalle [anki:play:q:0]	Die Vorhalle , Die Veranden Porch [anki:play:a:0]
Mitglied [anki:play:q:0]	Das Mitglied , Die Angehörigen Member [anki:play:a:0]
Schwimmbecken [anki:play:q:0]	Das Schwimmbecken , Die Pools Pool [anki:play:a:0]
Bedürfnis [anki:play:q:0]	Das Bedürfnis , Die Bedürfnisse Need [anki:play:a:0]
Hoffnung [anki:play:q:0]	Die Hoffnung , Die Hoffnungen Hope [anki:play:a:0]
See [anki:play:q:0]	Der See , Die Seen Lake [anki:play:a:0]
Überraschung [anki:play:q:0]	Die Überraschung , Die Überraschungen Surprise [anki:play:a:0]
Interesse [anki:play:q:0]	Die Interesse , Die Interessen Interest [anki:play:a:0]
Block [anki:play:q:0]	Der Block , Die Blöcke Block [anki:play:a:0]
Sprache [anki:play:q:0]	Die Sprache , Die Sprachen Language [anki:play:a:0]
Brücke [anki:play:q:0]	Die Brücke , Die Brücken Bridge [anki:play:a:0]
Zelle [anki:play:q:0]	Die Zelle , Die Zellen Cell [anki:play:a:0]
Wahl [anki:play:q:0]	Die Wahl , Die Entscheidungen Choice [anki:play:a:0]
Reihe [anki:play:q:0]	Die Reihe , Die Reihen Row [anki:play:a:0]
Gespräch [anki:play:q:0]	Das Gespräch , Die Gespräche Talk [anki:play:a:0]
Flugzeug [anki:play:q:0]	Das Flugzeug , Die Flugzeuge Plane [anki:play:a:0]
Uhr [anki:play:q:0]	Die Uhr , Die Uhren Watch [anki:play:a:0]
Information [anki:play:q:0]	Die Information , Die Informationen Information [anki:play:a:0]
Großmutter [anki:play:q:0]	Die Großmutter , Die Großmütter Grandmother [anki:play:a:0]
Flügel [anki:play:q:0]	Der Flügel , Die Flügel Wing [anki:play:a:0]
Bob [anki:play:q:0]	Die Bob , Die Bobs Bob [anki:play:a:0]
Club [anki:play:q:0]	Der Club , Die Vereine Club [anki:play:a:0]
Meister [anki:play:q:0]	Der Meister , Die Meister Master [anki:play:a:0]
Gnade [anki:play:q:0]	Die Gnade , Die Gnaden Grace [anki:play:a:0]
Wald [anki:play:q:0]	Der Wald , Die Wälder Forest [anki:play:a:0]
Größe [anki:play:q:0]	Die Größe , Die Größen Size [anki:play:a:0]
Satz [anki:play:q:0]	Der Satz , Die Sätze Set [anki:play:a:0]
Ehe [anki:play:q:0]	Die Ehe , Die Ehen Marriage [anki:play:a:0]
Stirn [anki:play:q:0]	Die Stirn , Die Stirn Forehead [anki:play:a:0]
Türöffnung [anki:play:q:0]	Die Türöffnung , Die Türen Doorway [anki:play:a:0]
Situation [anki:play:q:0]	Die Situation , Die Situationen Situation [anki:play:a:0]
Zähler [anki:play:q:0]	Der Zähler , Die Zähler Counter [anki:play:a:0]
Nachbar [anki:play:q:0]	Der Nachbar , Die Nachbarn Neighbor [anki:play:a:0]
Foto [anki:play:q:0]	Das Foto , Die Fotos Photo [anki:play:a:0]
Bühne [anki:play:q:0]	Die Bühne , Die Stufen Stage [anki:play:a:0]
Treffen [anki:play:q:0]	Das Treffen , Die Sitzungen Meeting [anki:play:a:0]
Krankenschwester [anki:play:q:0]	Die Krankenschwester , Die Krankenschwestern Nurse [anki:play:a:0]
Sicherheit [anki:play:q:0]	Die Sicherheit , Die Wertpapiere Security [anki:play:a:0]
Ereignis [anki:play:q:0]	Das Ereignis , Die Events Event [anki:play:a:0]
Decke [anki:play:q:0]	Die Decke , Die Decken teto, forro, cobertor [anki:play:a:0]
Motor [anki:play:q:0]	Der Motor , Die Motoren Engine [anki:play:a:0]
Geschenk [anki:play:q:0]	Das Geschenk , Die Geschenke Gift [anki:play:a:0]
Restaurant [anki:play:q:0]	Das Restaurant , Die Restaurants Restaurant [anki:play:a:0]
Tafel [anki:play:q:0]	Die Tafel , Die Bretter Board [anki:play:a:0]
Flur [anki:play:q:0]	Der Flur , Die Flure Hallway [anki:play:a:0]
Armee [anki:play:q:0]	Die Armee , Die Armeen Army [anki:play:a:0]
Aufwand [anki:play:q:0]	Der Aufwand , --- Effort [anki:play:a:0]
Osten [anki:play:q:0]	Der Osten , Die Easts East [anki:play:a:0]
Zukunft [anki:play:q:0]	Die Zukunft , Die Zukünfte Future [anki:play:a:0]
Hose [anki:play:q:0]	Die Hose , Die Hose Pant [anki:play:a:0]
Leder [anki:play:q:0]	Das Leder , Die Leder Leather [anki:play:a:0]
Flug [anki:play:q:0]	Der Flug , Die Flüge Flight [anki:play:a:0]
Geschlecht [anki:play:q:0]	Das Geschlecht , Die Sexs Sex [anki:play:a:0]
Gericht [anki:play:q:0]	Das Gericht , Die Gerichte Court [anki:play:a:0]
Kurs [anki:play:q:0]	Der Kurs , Die Kurse Course [anki:play:a:0]
Dreck [anki:play:q:0]	Der Dreck , Die Dirts Dirt [anki:play:a:0]
Ei [anki:play:q:0]	Das Ei , Die Eier Egg [anki:play:a:0]
Kinn [anki:play:q:0]	Das Kinn , Die Kinne Chin [anki:play:a:0]
Fremde [anki:play:q:0]	Der Fremde , Die Fremden Stranger [anki:play:a:0]
Freude [anki:play:q:0]	Die Freude , Die Freuden Pleasure [anki:play:a:0]
Detail [anki:play:q:0]	Das Detail , Die Details Detail [anki:play:a:0]
Besatzung [anki:play:q:0]	Die Besatzung , Die Besatzungen Crew [anki:play:a:0]
Gast [anki:play:q:0]	Der Gast , Die Gäste Guest [anki:play:a:0]
Erlebnis [anki:play:q:0]	Das Erlebnis , Erfahrungen Experience [anki:play:a:0]
Witz [anki:play:q:0]	Der Witz , Die Witze Joke [anki:play:a:0]
Sand [anki:play:q:0]	Der Sand , Der Sand Sand [anki:play:a:0]
Faust [anki:play:q:0]	Die Faust , Die Fäuste Fist [anki:play:a:0]
Aktion [anki:play:q:0]	Die Aktion , Die Aktionen Action [anki:play:a:0]
Wandern [anki:play:q:0]	Das Wandern , Die Wanderungen Walk [anki:play:a:0]
Deal [anki:play:q:0]	Der Deal , Die Angebote Deal [anki:play:a:0]
Natur [anki:play:q:0]	Die Natur , Die Natur Nature [anki:play:a:0]
Cousin [anki:play:q:0]	Der Cousin , Die Cousinen Cousin [anki:play:a:0]
Bewegung [anki:play:q:0]	Die Bewegung , Die Bewegungen Movement [anki:play:a:0]
Fleisch [anki:play:q:0]	Das Fleisch , Die Konkretisiert Flesh [anki:play:a:0]
Datensatz [anki:play:q:0]	Der Datensatz , Datensätze Record [anki:play:a:0]
Camp [anki:play:q:0]	Das Camp , Die Lager Camp [anki:play:a:0]
Zeitung [anki:play:q:0]	Die Zeitung , Die Zeitung Newspaper [anki:play:a:0]
Strahl [anki:play:q:0]	Der Strahl , Die Strahlen Ray [anki:play:a:0]
Mensch [anki:play:q:0]	Der Mensch , Die Menschen Human [anki:play:a:0]
Sofa [anki:play:q:0]	Das Sofa , Die Liegen Couch [anki:play:a:0]
Großvater [anki:play:q:0]	Der Großvater , Die Großväter Grandfather [anki:play:a:0]
Fotografie [anki:play:q:0]	Die Fotografie , Die Photographes Photograph [anki:play:a:0]
Geheimnis [anki:play:q:0]	Das Geheimnis , Geheimnisse Secret [anki:play:a:0]
Schönheit [anki:play:q:0]	Die Schönheit , Die Schönheiten Beauty [anki:play:a:0]
Vorhandensein [anki:play:q:0]	Das Vorhandensein , Die Präsenzen Presence [anki:play:a:0]
Glocke [anki:play:q:0]	Die Glocke , Die Glocken Bell [anki:play:a:0]
Volks [anki:play:q:0]	Die Volks , Die Leute Folk [anki:play:a:0]
Knopf [anki:play:q:0]	Der Knopf , Die Knöpfe Button [anki:play:a:0]
Liste [anki:play:q:0]	Die Liste , Die Listen List [anki:play:a:0]
Level [anki:play:q:0]	Das Level , Die Niveaus Level [anki:play:a:0]
Datum [anki:play:q:0]	Das Datum , Die Daten Date [anki:play:a:0]
Thema [anki:play:q:0]	Das Thema , Die Themen Subject [anki:play:a:0]
Unterschied [anki:play:q:0]	Der Unterschied , Die Unterschiede Difference [anki:play:a:0]
Pause [anki:play:q:0]	Die Pause , Die Pausen Pause [anki:play:a:0]
Van [anki:play:q:0]	Der Van , Die Wagen Van [anki:play:a:0]
Klinge [anki:play:q:0]	Die Klinge , Die Klingen Blade [anki:play:a:0]
Fernsehen [anki:play:q:0]	Das Fernsehen , Die Fernseher Television [anki:play:a:0]
Vergangenheit [anki:play:q:0]	Die Vergangenheit , Die Vergangenheit Past [anki:play:a:0]
Bauernhof [anki:play:q:0]	Der Bauernhof , Die Bauernhöfe Farm [anki:play:a:0]
Runden [anki:play:q:0]	Die Runden , Die Runden Lap [anki:play:a:0]
Band [anki:play:q:0]	Die Band , Die Bands Band [anki:play:a:0]
Anwalt [anki:play:q:0]	Der Anwalt , Die Anwälte Lawyer [anki:play:a:0]
Ast [anki:play:q:0]	Der Ast , Die Zweige Branch [anki:play:a:0]
Rahmen [anki:play:q:0]	Der Rahmen , Die Rahmen Frame [anki:play:a:0]
Deck [anki:play:q:0]	Das Deck , Die Decks Deck [anki:play:a:0]
Effekt [anki:play:q:0]	Der Effekt , Die Effekte Effect [anki:play:a:0]
Tanz [anki:play:q:0]	Der Tanz , Die Tänze Dance [anki:play:a:0]
Sicht [anki:play:q:0]	Die Sicht , Die Visionen Vision [anki:play:a:0]
Gespenst [anki:play:q:0]	Das Gespenst , Die Geister Ghost [anki:play:a:0]
Esel [anki:play:q:0]	Der Esel , Die Esel Ass [anki:play:a:0]
Charakter [anki:play:q:0]	Der Charakter , Die Charaktere Character [anki:play:a:0]
Auf [anki:play:q:0]	Das Auf Wiedersehen , Die Verabschiedungen GoodBye [anki:play:a:0]
Frühstück [anki:play:q:0]	Das Frühstück , Das Frühstück Breakfast [anki:play:a:0]
Geste [anki:play:q:0]	Die Geste , Die Gesten Gesture [anki:play:a:0]
Glück [anki:play:q:0]	Das Glück , Die Lucks Luck [anki:play:a:0]
Gas [anki:play:q:0]	Das Gas , Die Gase Gas [anki:play:a:0]
Korridor [anki:play:q:0]	Der Korridor , Die Flure Corridor [anki:play:a:0]
Professor [anki:play:q:0]	Der Professor , Die Professoren Professor [anki:play:a:0]
Fehler [anki:play:q:0]	Der Fehler , Die Fehler Mistake [anki:play:a:0]
Universität [anki:play:q:0]	Die Universität , Die Universitäten University [anki:play:a:0]
Ozean [anki:play:q:0]	Der Ozean , Die Ozeane Ocean [anki:play:a:0]
Jahrhundert [anki:play:q:0]	Das Jahrhundert , Die Jahrhunderte Century [anki:play:a:0]
Honig [anki:play:q:0]	Der Honig , Honige Honey [anki:play:a:0]
Stapel [anki:play:q:0]	Der Stapel , Die Pfähle Pile [anki:play:a:0]
Schale [anki:play:q:0]	Die Schale , Die Schalen Bowl [anki:play:a:0]
Zaun [anki:play:q:0]	Der Zaun , Die Zäune Fence [anki:play:a:0]
Regel [anki:play:q:0]	Die Regel , Die Regeln Rule [anki:play:a:0]
Gelächter [anki:play:q:0]	Das Gelächter , Die Gelächter Laughter [anki:play:a:0]
Wut [anki:play:q:0]	Die Wut , Die Angers Anger [anki:play:a:0]
Schweiß [anki:play:q:0]	Der Schweiß , Die Schweißausbrüche Sweat [anki:play:a:0]
Wetter [anki:play:q:0]	Das Wetter , Die Wind Und Wetter Weather [anki:play:a:0]
Entscheidung [anki:play:q:0]	Die Entscheidung , Die Entscheidungen Decision [anki:play:a:0]
Engel [anki:play:q:0]	Der Engel , Die Engel Angel [anki:play:a:0]
Stärke [anki:play:q:0]	Die Stärke , Die Stärken Strength [anki:play:a:0]
Huhn [anki:play:q:0]	Das Huhn , Die Hühner Chicken [anki:play:a:0]
Studium [anki:play:q:0]	Das Studium , Die Studien Study [anki:play:a:0]
Handgelenk [anki:play:q:0]	Das Handgelenk , Die Handgelenke Wrist [anki:play:a:0]
Halt [anki:play:q:0]	Der Halt , Die Anschläge Stop [anki:play:a:0]
Hüfte [anki:play:q:0]	Die Hüfte , Die Hüften Hip [anki:play:a:0]
Regierung [anki:play:q:0]	Die Regierung , Die Regierungen Government [anki:play:a:0]
Königin [anki:play:q:0]	Die Königin , Die Königinnen Queen [anki:play:a:0]
Schweif [anki:play:q:0]	Der Schweif , Die Schwänze Tail [anki:play:a:0]
Pflanze [anki:play:q:0]	Die Pflanze , Die Pflanzen Plant [anki:play:a:0]
Flamme [anki:play:q:0]	Die Flamme , Die Flammen Flame [anki:play:a:0]
Gürtel [anki:play:q:0]	Der Gürtel , Die Gürtel Belt [anki:play:a:0]
Nachbarschaft [anki:play:q:0]	Die Nachbarschaft , Die Nachbarschaften Neighborhood [anki:play:a:0]
Energie [anki:play:q:0]	Die Energie , Die Energien Energy [anki:play:a:0]
Grün [anki:play:q:0]	Das Grün , Die Grünen Green [anki:play:a:0]
Viertel [anki:play:q:0]	Das Viertel , Die Viertel Quarter [anki:play:a:0]
Feind [anki:play:q:0]	Der Feind , Die Feinde Enemy [anki:play:a:0]
Eingang [anki:play:q:0]	Der Eingang , Die Zugänge Entrance [anki:play:a:0]
Bibliothek [anki:play:q:0]	Die Bibliothek , Die Bibliotheken Library [anki:play:a:0]
Verfasser [anki:play:q:0]	Der Verfasser , Die Autoren Writer [anki:play:a:0]
Frieden [anki:play:q:0]	Der Frieden , Die Peaces Peace [anki:play:a:0]
Berührung [anki:play:q:0]	Die Berührung , Die Berührungen Touch [anki:play:a:0]
Topf [anki:play:q:0]	Der Topf , Die Töpfe Pot [anki:play:a:0]
Typ [anki:play:q:0]	Der Typ , Die Typen Type [anki:play:a:0]
Seil [anki:play:q:0]	Das Seil , Die Seile Rope [anki:play:a:0]
Muskel [anki:play:q:0]	Der Muskel , Die Muskeln Muscle [anki:play:a:0]
Gemälde [anki:play:q:0]	Das Gemälde , Die Gemälde Painting [anki:play:a:0]
Gardine [anki:play:q:0]	Die Gardine , Die Vorhänge Curtain [anki:play:a:0]
Akt [anki:play:q:0]	Der Akt , Die Handlungen Act [anki:play:a:0]
Wolf [anki:play:q:0]	Der Wolf , Die Wölfe Wolf [anki:play:a:0]
Kajüte [anki:play:q:0]	Die Kajüte , Die Kabinen Cabin [anki:play:a:0]
Ladung [anki:play:q:0]	Die Ladung , Die Ladungen Charge [anki:play:a:0]
Passagier [anki:play:q:0]	Der Passagier , Die Passagiere Passenger [anki:play:a:0]
Kumpel [anki:play:q:0]	Der Kumpel , Die Freunde Buddy [anki:play:a:0]
Verwendung [anki:play:q:0]	Die Verwendung , Die Verwendungen Use [anki:play:a:0]
Verkehr [anki:play:q:0]	Der Verkehr , Die Verkehre Traffic [anki:play:a:0]
Relief [anki:play:q:0]	Das Relief , Die Reliefs Relief [anki:play:a:0]
Kappe [anki:play:q:0]	Die Kappe , Die Kappen Cap [anki:play:a:0]
Rudel [anki:play:q:0]	Das Rudel , Die Packungen Pack [anki:play:a:0]
Wochenende [anki:play:q:0]	Das Wochenende , Die Wochenenden Weekend [anki:play:a:0]
Stand [anki:play:q:0]	Der Stand , Die Stände Stand [anki:play:a:0]
Aufzug [anki:play:q:0]	Der Aufzug , Die Aufzüge Elevator [anki:play:a:0]
Geburtstag [anki:play:q:0]	Der Geburtstag , Die Geburtstage Birthday [anki:play:a:0]
Lilie [anki:play:q:0]	Die Lilie , Die Lilien Lily [anki:play:a:0]
Bügeleisen [anki:play:q:0]	Das Bügeleisen , Die Eisen Iron [anki:play:a:0]
Augenbraue [anki:play:q:0]	Die Augenbraue , Die Augenbrauen Eyebrow [anki:play:a:0]
Geschwindigkeit [anki:play:q:0]	Die Geschwindigkeit , Die Geschwindigkeiten Speed [anki:play:a:0]
Absicht [anki:play:q:0]	Die Absicht , Die Zwecke Purpose [anki:play:a:0]
Rock [anki:play:q:0]	Der Rock , Die Röcke Skirt [anki:play:a:0]
Quadrat [anki:play:q:0]	Das Quadrat , Die Quadrate Square [anki:play:a:0]
Fahrt [anki:play:q:0]	Die Fahrt , Die Antriebe Drive [anki:play:a:0]
Artikel [anki:play:q:0]	Den Artikel , Die Artikel Article [anki:play:a:0]
Englisch [anki:play:q:0]	Das Englisch , Die Englishes English [anki:play:a:0]
Turm [anki:play:q:0]	Der Turm , Die Türme Tower [anki:play:a:0]
Kampf [anki:play:q:0]	Der Kampf , Die Schlachten Battle [anki:play:a:0]
Rennen [anki:play:q:0]	Das Rennen , Die Rennen Race [anki:play:a:0]
Schock [anki:play:q:0]	Der Schock , Die Schocks Shock [anki:play:a:0]
Sektion [anki:play:q:0]	Die Sektion , Die Abschnitte Section [anki:play:a:0]
Schwert [anki:play:q:0]	Das Schwert , Die Schwerter Sword [anki:play:a:0]
Stock [anki:play:q:0]	Der Stock , Die Stöcke Stick [anki:play:a:0]
Datei [anki:play:q:0]	Die Datei , Die Dateien File [anki:play:a:0]
Brot [anki:play:q:0]	Das Brot , Die Brote Bread [anki:play:a:0]
Öl [anki:play:q:0]	Das Öl , Die Öle Oil [anki:play:a:0]
Kette [anki:play:q:0]	Die Kette , Die Ketten Chain [anki:play:a:0]
Abteilung [anki:play:q:0]	Die Abteilung , Die Abteilungen Department [anki:play:a:0]
Mord [anki:play:q:0]	Der Mord , Die Morde Murder [anki:play:a:0]
Bär [anki:play:q:0]	Der Bär , Die Bären Bear [anki:play:a:0]
Test [anki:play:q:0]	Der Test , Die Tests Test [anki:play:a:0]
Besuch [anki:play:q:0]	Der Besuch , Die Besuche Visit [anki:play:a:0]
Milch [anki:play:q:0]	Die Milch , Die Milch Milk [anki:play:a:0]
Chef [anki:play:q:0]	Der Chef , Die Bosse Boss [anki:play:a:0]
Ellbogen [anki:play:q:0]	Der Ellbogen , Die Ellbogen Elbow [anki:play:a:0]
Verlangen [anki:play:q:0]	Das Verlangen , Die Wünsche Desire [anki:play:a:0]
Patient [anki:play:q:0]	Der Patient , Die Patienten Patient [anki:play:a:0]
Grinsen [anki:play:q:0]	Das Grinsen , Die Grins Grin [anki:play:a:0]
Liebhaber [anki:play:q:0]	Der Liebhaber , Die Liebhaber Lover [anki:play:a:0]
Preis [anki:play:q:0]	Der Preis , Die Preise Price [anki:play:a:0]
Wissen [anki:play:q:0]	Das Wissen , Die Erkenntnisse Knowledge [anki:play:a:0]
Anfang [anki:play:q:0]	Der Anfang , Die Anfänge Beginning [anki:play:a:0]
Kälte [anki:play:q:0]	Die Kälte , Die Erkältung Cold [anki:play:a:0]
Schrank [anki:play:q:0]	Der Schrank , Die Schränke Closet [anki:play:a:0]
Morgendämmerung [anki:play:q:0]	Die Morgendämmerung , Im Morgengrauen Dawn [anki:play:a:0]
Tempel [anki:play:q:0]	Der Tempel , Die Tempel Temple [anki:play:a:0]
Pflicht [anki:play:q:0]	Die Pflicht , Die Pflichten Duty [anki:play:a:0]
Übung [anki:play:q:0]	Die Übung , die Übungen Practice [anki:play:a:0]
Ferse [anki:play:q:0]	Die Ferse , Die Fersen Heel [anki:play:a:0]
Tal [anki:play:q:0]	Das Tal , Die Täler Valley [anki:play:a:0]
Kabel [anki:play:q:0]	Das Kabel , Die Drähte Wire [anki:play:a:0]
Jeans [anki:play:q:0]	Die Jeans , Die Jeanses Jeans [anki:play:a:0]
Kuss [anki:play:q:0]	Der Kuss , Die Küsse Kiss [anki:play:a:0]
Kiefer [anki:play:q:0]	Der Kiefer , Die Backen Jaw [anki:play:a:0]
Lauf [anki:play:q:0]	der Lauf , die Läufe Run [anki:play:a:0]
Verhältnis [anki:play:q:0]	Das Verhältnis , Die Beziehungen Relationship [anki:play:a:0]
Objekt [anki:play:q:0]	Das Objekt , Die Objekte Object [anki:play:a:0]
Angriff [anki:play:q:0]	Der Angriff , Die Angriffe Attack [anki:play:a:0]
Autobahn [anki:play:q:0]	Die Autobahn , Die Autobahnen Highway [anki:play:a:0]
Schattierung [anki:play:q:0]	Die Schattierung , Die Schatten Shade [anki:play:a:0]
Verbrechen [anki:play:q:0]	Das Verbrechen , Die Verbrechen Crime [anki:play:a:0]
Weiß [anki:play:q:0]	Das Weiß , Die Weißen White [anki:play:a:0]
Partner [anki:play:q:0]	Der Partner , Die Partner Partner [anki:play:a:0]
Priester [anki:play:q:0]	Der Priester , Die Priester Priest [anki:play:a:0]
Rasen [anki:play:q:0]	Der Rasen , Der Rasen Lawn [anki:play:a:0]
Lachen [anki:play:q:0]	Das Lachen , Die Lachen Laugh [anki:play:a:0]
Kofferraum [anki:play:q:0]	Der Kofferraum , Die Stämme Trunk [anki:play:a:0]
Weinen [anki:play:q:0]	Das Weinen , Die Schreie Cry [anki:play:a:0]
Programm [anki:play:q:0]	Das Programm , Die Programme Program [anki:play:a:0]
Regal [anki:play:q:0]	Das Regal , Die Regale Shelf [anki:play:a:0]
Gentleman [anki:play:q:0]	Der Gentleman , The Gentlemans Gentleman [anki:play:a:0]
Sein [anki:play:q:0]	Das Sein , Die Wesen Being [anki:play:a:0]
Stahl [anki:play:q:0]	Der Stahl , Die Stähle Steel [anki:play:a:0]
Bürgersteig [anki:play:q:0]	Der Bürgersteig , Die Bürgersteige Sidewalk [anki:play:a:0]
Uniform [anki:play:q:0]	Die Uniform , Die Uniformen Uniform [anki:play:a:0]
Muster [anki:play:q:0]	Das Muster , Die Muster Pattern [anki:play:a:0]
Beweis [anki:play:q:0]	Der Beweis , Die Beweise Evidence [anki:play:a:0]
Spieler [anki:play:q:0]	Der Spieler , Die Spieler Player [anki:play:a:0]
Roman [anki:play:q:0]	Der Roman , Die Romane Novel [anki:play:a:0]
Kissen [anki:play:q:0]	Das Kissen , Die Kissen Pillow [anki:play:a:0]
Lampe [anki:play:q:0]	Die Lampe , Die Lampen Lamp [anki:play:a:0]
Schublade [anki:play:q:0]	Die Schublade , Die Schubladen Drawer [anki:play:a:0]
Gefahr [anki:play:q:0]	Die Gefahr , Die Gefahren Danger [anki:play:a:0]
Detektiv [anki:play:q:0]	Der Detektiv , Die Detektive Detective [anki:play:a:0]
Denken [anki:play:q:0]	Das Denken , Die Gedanken Thinking [anki:play:a:0]
Riss [anki:play:q:0]	Der Riss , Die Risse Crack [anki:play:a:0]
Gebet [anki:play:q:0]	Das Gebet , Die Gebete Prayer [anki:play:a:0]
Handtuch [anki:play:q:0]	Das Handtuch , Die Handtücher Towel [anki:play:a:0]
Handschuh [anki:play:q:0]	Der Handschuh , Die Handschuhe Glove [anki:play:a:0]
Bucht [anki:play:q:0]	Die Bucht , Die Buchten Bay [anki:play:a:0]
Publikum [anki:play:q:0]	Das Publikum , Das Publikum Audience [anki:play:a:0]
Dose [anki:play:q:0]	Die Dose , Die Dosen Can [anki:play:a:0]
Bedingung [anki:play:q:0]	Die Bedingung , Die Bedingungen Condition [anki:play:a:0]
Taille [anki:play:q:0]	Die Taille , Die Taille Waist [anki:play:a:0]
Druck [anki:play:q:0]	Der Druck , Die Drücke Pressure [anki:play:a:0]
Waschbecken [anki:play:q:0]	Das Waschbecken , Die Waschbecken Sink [anki:play:a:0]
Rückkehr [anki:play:q:0]	Die Rückkehr , Die Renditen Return [anki:play:a:0]
Brise [anki:play:q:0]	Die Brise , Die Lüfte Breeze [anki:play:a:0]
Geschmack [anki:play:q:0]	Der Geschmack , Die Geschmäcker Taste [anki:play:a:0]
Strom [anki:play:q:0]	Der Strom , Bäche Stream [anki:play:a:0]
Ergebnis [anki:play:q:0]	Das Ergebnis , Die Ergebnisse Result [anki:play:a:0]
Autor [anki:play:q:0]	Der Autor , Die Autoren Author [anki:play:a:0]
Trinkgeld [anki:play:q:0]	Das Trinkgeld , Die Spitzen Tip [anki:play:a:0]
Dusche [anki:play:q:0]	Die Dusche , Die Duschen Shower [anki:play:a:0]
Zehe [anki:play:q:0]	Die Zehe , Die Zehen Toe [anki:play:a:0]
Jahreszeit [anki:play:q:0]	Die Jahreszeit , Die Jahreszeiten Season [anki:play:a:0]
Hälfte [anki:play:q:0]	Die Hälfte , Die Hälften Half [anki:play:a:0]
Dummkopf [anki:play:q:0]	Der Dummkopf , Die Narren Fool [anki:play:a:0]
Tunnel [anki:play:q:0]	Der Tunnel , Die Tunnel Tunnel [anki:play:a:0]
Klient [anki:play:q:0]	Der Klient , Die Clients Client [anki:play:a:0]
Garage [anki:play:q:0]	Die Garage , Die Garagen Garage [anki:play:a:0]
Mission [anki:play:q:0]	Die Mission , Die Missionen Mission [anki:play:a:0]
Kugel [anki:play:q:0]	Die Kugel , Die Kugeln Bullet [anki:play:a:0]
Markt [anki:play:q:0]	Der Markt , Die Märkte Market [anki:play:a:0]
Verlust [anki:play:q:0]	Der Verlust , Die Verluste Loss [anki:play:a:0]
Stift [anki:play:q:0]	Der Stift , Die Stifte Pen [anki:play:a:0]
Begriff [anki:play:q:0]	Der Begriff , Die Begriffe Term [anki:play:a:0]
Gedicht [anki:play:q:0]	Das Gedicht , Die Gedichte Poem [anki:play:a:0]
Prinz [anki:play:q:0]	Der Prinz , Die Fürsten Prince [anki:play:a:0]
Schloss [anki:play:q:0]	Das Schloss , Die Schlösser Lock [anki:play:a:0]
Realität [anki:play:q:0]	Die Realität , Die Wirklichkeiten Reality [anki:play:a:0]
Schlange [anki:play:q:0]	Die Schlange , Die Schlangen Snake [anki:play:a:0]
Apfel [anki:play:q:0]	Der Apfel , Die Äpfel Apple [anki:play:a:0]
Maske [anki:play:q:0]	Die Maske , Die Masken Mask [anki:play:a:0]
Kunden [anki:play:q:0]	Dem Kunden , Die Kunden Customer [anki:play:a:0]
Geburt [anki:play:q:0]	Die Geburt , Die Geburten Birth [anki:play:a:0]
Wunder [anki:play:q:0]	Das Wunder , Wunder Wonder [anki:play:a:0]
Sonnenlicht [anki:play:q:0]	Das Sonnenlicht , Die Sunlights Sunlight [anki:play:a:0]
Panzer [anki:play:q:0]	Der Panzer , Die Tanks Tank [anki:play:a:0]
Personal [anki:play:q:0]	Das Personal , Die Mitarbeiter Staff [anki:play:a:0]
Lüge [anki:play:q:0]	Die Lüge , Die Lügen Lie [anki:play:a:0]
Glaube [anki:play:q:0]	Der Glaube , Die Glaubensrichtungen Faith [anki:play:a:0]
Ehre [anki:play:q:0]	Die Ehre , Ehrungen Honor [anki:play:a:0]
Creme [anki:play:q:0]	Die Creme , Die Cremes Cream [anki:play:a:0]
Opfer [anki:play:q:0]	Das Opfer , Die Opfer Victim [anki:play:a:0]
Möglichkeit [anki:play:q:0]	Die Möglichkeit , Die Möglichkeiten Possibility [anki:play:a:0]
Kontakt [anki:play:q:0]	Der Kontakt , Die Kontakte Contact [anki:play:a:0]
Stimmung [anki:play:q:0]	Die Stimmung , Die Stimmungen Mood [anki:play:a:0]
Daumen [anki:play:q:0]	Der Daumen , Die Daumen Thumb [anki:play:a:0]
Lesen [anki:play:q:0]	Das Lesen , Die Messwerte Reading [anki:play:a:0]
Kerze [anki:play:q:0]	Die Kerze , Die Kerzen Candle [anki:play:a:0]
Höhle [anki:play:q:0]	Die Höhle , Die Höhlen Cave [anki:play:a:0]
Post [anki:play:q:0]	Die Post , Die Pfosten Post [anki:play:a:0]
Gefängnis [anki:play:q:0]	Das Gefängnis , Die Gefängnisse Prison [anki:play:a:0]
Emotion [anki:play:q:0]	Die Emotion , Die Emotionen Emotion [anki:play:a:0]
Führer [anki:play:q:0]	Der Führer , Die Führer Leader [anki:play:a:0]
Grad [anki:play:q:0]	Der Grad , Grade Degree [anki:play:a:0]
Eigenschaft [anki:play:q:0]	Die Eigenschaft , Die Funktionen Feature [anki:play:a:0]
Ticket [anki:play:q:0]	Das Ticket , Die Tickets Ticket [anki:play:a:0]
Alien [anki:play:q:0]	Das Alien , Die Aliens Alien [anki:play:a:0]
Unterricht [anki:play:q:0]	Der Unterricht , Die Stunden Lesson [anki:play:a:0]
Wüste [anki:play:q:0]	Die Wüste , Die Wüsten Desert [anki:play:a:0]
Schnitt [anki:play:q:0]	Der Schnitt , Die Schnitte Cut [anki:play:a:0]
Unordnung [anki:play:q:0]	Die Unordnung , Die Kasinos Mess [anki:play:a:0]
Warnung [anki:play:q:0]	Die Warnung , Die Warnungen Warning [anki:play:a:0]
Märchen [anki:play:q:0]	Das Märchen , Die Geschichten Tale [anki:play:a:0]
Begräbnis [anki:play:q:0]	Das Begräbnis , Die Beerdigungen Funeral [anki:play:a:0]
Taxi [anki:play:q:0]	Das Taxi , Die Kabinen Cab [anki:play:a:0]
Theater [anki:play:q:0]	Das Theater , Die Theater Theater [anki:play:a:0]
Länge [anki:play:q:0]	Die Länge , Die Längen Length [anki:play:a:0]
Schlamm [anki:play:q:0]	Der Schlamm , Die Schlämme Mud [anki:play:a:0]
Wissenschaft [anki:play:q:0]	Die Wissenschaft , Die Wissenschaften Science [anki:play:a:0]
Schnur [anki:play:q:0]	Die Schnur , Die Streicher String [anki:play:a:0]
Rede [anki:play:q:0]	Die Rede , Die Reden Speech [anki:play:a:0]
Kopie [anki:play:q:0]	Die Kopie , Die Kopien Copy [anki:play:a:0]
Kuh [anki:play:q:0]	Die Kuh , Die Kühe Cow [anki:play:a:0]
Arbeiter [anki:play:q:0]	Der Arbeiter , Die Arbeiter Worker [anki:play:a:0]
Oberschenkel [anki:play:q:0]	Der Oberschenkel , Die Thighes Thigh [anki:play:a:0]
Labor [anki:play:q:0]	Das Labor , Die Labore Lab [anki:play:a:0]
Rolle [anki:play:q:0]	Die Rolle , Die Walzen Roll [anki:play:a:0]
Obst [anki:play:q:0]	Das Obst , Die Früchte Fruit [anki:play:a:0]
Patch [anki:play:q:0]	Der Patch , Die Patches Patch [anki:play:a:0]
Seide [anki:play:q:0]	Die Seide , Die Seide Silk [anki:play:a:0]
Buck [anki:play:q:0]	Der Buck , Die Böcke Buck [anki:play:a:0]
Ziegel [anki:play:q:0]	Die Ziegel , Die Ziegel Brick [anki:play:a:0]
Gewehr [anki:play:q:0]	Das Gewehr , Die Gewehre Rifle [anki:play:a:0]
Karriere [anki:play:q:0]	Die Karriere , Die Karrieren Career [anki:play:a:0]
Gelegenheit [anki:play:q:0]	Die Gelegenheit , Die Gelegenheiten Opportunity [anki:play:a:0]
Direktor [anki:play:q:0]	Der Direktor , Die Direktoren Director [anki:play:a:0]
Monster [anki:play:q:0]	Das Monster , Die Monster Monster [anki:play:a:0]
Fahrzeug [anki:play:q:0]	Das Fahrzeug , Die Fahrzeuge Vehicle [anki:play:a:0]
Gasse [anki:play:q:0]	Die Gasse , Die Gassen Alley [anki:play:a:0]
Hülse [anki:play:q:0]	Die Hülse , Die Ärmel Sleeve [anki:play:a:0]
Grab [anki:play:q:0]	Das Grab , Die Gräber Grave [anki:play:a:0]
Busch [anki:play:q:0]	Der Busch , Die Büsche Bush [anki:play:a:0]
Speisesaal [anki:play:q:0]	Der Speisesaal , Die Dinings Dining [anki:play:a:0]
Eröffnung [anki:play:q:0]	Die Eröffnung , Die Öffnungen Opening [anki:play:a:0]
Zwilling [anki:play:q:0]	Der Zwilling , Die Zwillinge Twin [anki:play:a:0]
Scheune [anki:play:q:0]	Die Scheune , Die Scheunen Barn [anki:play:a:0]
Pfund [anki:play:q:0]	Das Pfund , Die Pfunde Pound [anki:play:a:0]
Blitz [anki:play:q:0]	Der Blitz , Die Blitze Flash [anki:play:a:0]
Richter [anki:play:q:0]	Der Richter , Die Richter Judge [anki:play:a:0]
Masse [anki:play:q:0]	Die Masse , Die Massen Mass [anki:play:a:0]
Prozess [anki:play:q:0]	Der Prozess , Die Prozesse Process [anki:play:a:0]
Geldbeutel [anki:play:q:0]	Der Geldbeutel , Die Geldbeutel Purse [anki:play:a:0]
Rohr [anki:play:q:0]	Das Rohr , Die Röhren Pipe [anki:play:a:0]
Drache [anki:play:q:0]	Der Drache , Die Drachen Dragon [anki:play:a:0]
Horizont [anki:play:q:0]	Der Horizont , Die Horizonte Horizon [anki:play:a:0]
Umschlag [anki:play:q:0]	Der Umschlag , Die Umschläge Envelope [anki:play:a:0]
Erwachsene [anki:play:q:0]	Die Erwachsene , Die Erwachsenen Adult [anki:play:a:0]
Material [anki:play:q:0]	Das Material , Die Materialien Material [anki:play:a:0]
Kindheit [anki:play:q:0]	Die Kindheit , Die Kindheit Childhood [anki:play:a:0]
Angewohnheit [anki:play:q:0]	Die Angewohnheit , Die Gewohnheiten Habit [anki:play:a:0]
Künstler [anki:play:q:0]	Der Künstler , Die Artisten Artist [anki:play:a:0]
Adresse [anki:play:q:0]	Die Adresse , Die Adressen Address [anki:play:a:0]
Duft [anki:play:q:0]	Der Duft , Die Düfte Scent [anki:play:a:0]
Universum [anki:play:q:0]	Das Universum , Die Universen Universe [anki:play:a:0]
Kopfnicken [anki:play:q:0]	Das Kopfnicken , Die Nickt Nod [anki:play:a:0]
Muschel [anki:play:q:0]	Die Muschel , Die Muscheln Shell [anki:play:a:0]
Gemeinde [anki:play:q:0]	Die Gemeinde , Die Gemeinden Community [anki:play:a:0]
Wunde [anki:play:q:0]	Die Wunde , Die Wunden Wound [anki:play:a:0]
Maus [anki:play:q:0]	Die Maus , Die Mäuse Mouse [anki:play:a:0]
Pilot [anki:play:q:0]	Der Pilot , Die Piloten Pilot [anki:play:a:0]
Video [anki:play:q:0]	Das Video , Die Videos Video [anki:play:a:0]
Korb [anki:play:q:0]	Der Korb , Die Körbe Basket [anki:play:a:0]
Wagen [anki:play:q:0]	Der Wagen , Die Wagen Wagon [anki:play:a:0]
Versuch [anki:play:q:0]	Der Versuch , Die Versuche Attempt [anki:play:a:0]
Kuchen [anki:play:q:0]	Der Kuchen , Die Kuchen Cake [anki:play:a:0]
Affäre [anki:play:q:0]	Die Affäre , Die Angelegenheiten Affair [anki:play:a:0]
Küste [anki:play:q:0]	Die Küste , Die Ufer Shore [anki:play:a:0]
Allgemeine [anki:play:q:0]	Die Allgemeine , Die Generäle General [anki:play:a:0]
Ursprung [anki:play:q:0]	Der Ursprung , Die Wurzeln Root [anki:play:a:0]
Robe [anki:play:q:0]	Die Robe , Die Gewänder Robe [anki:play:a:0]
Sorge [anki:play:q:0]	Die Sorge , die Sorgen Concern [anki:play:a:0]
Presse [anki:play:q:0]	Die Presse , Die Pressen Press [anki:play:a:0]
Ratte [anki:play:q:0]	Die Ratte , Die Ratten Rat [anki:play:a:0]
Gesellschaft [anki:play:q:0]	Die Gesellschaft , Die Gesellschaften Society [anki:play:a:0]
Stil [anki:play:q:0]	Der Stil , Die Stile Style [anki:play:a:0]
Befehl [anki:play:q:0]	Der Befehl , Die Befehle Command [anki:play:a:0]
Besucher [anki:play:q:0]	Der Besucher , Die Besucher Visitor [anki:play:a:0]
Model [anki:play:q:0]	Das Model , Die Modelle Model [anki:play:a:0]
Kammer [anki:play:q:0]	Die Kammer , Die Kammern Chamber [anki:play:a:0]
Biest [anki:play:q:0]	Das Biest , Die Tiere Beast [anki:play:a:0]
Bündel [anki:play:q:0]	Das Bündel , Die Trauben Bunch [anki:play:a:0]
Hintergrund [anki:play:q:0]	Der Hintergrund , Die Hintergründe Background [anki:play:a:0]
Einheit [anki:play:q:0]	Die Einheit , Die Einheiten Unit [anki:play:a:0]
Möbel [anki:play:q:0]	Die Möbel , Die Möbel Furniture [anki:play:a:0]
Nagel [anki:play:q:0]	Der Nagel , Die Nägel Nail [anki:play:a:0]
Schrei [anki:play:q:0]	Der Schrei , Die Schreie Scream [anki:play:a:0]
Ausrüstung [anki:play:q:0]	Die Ausrüstung , Die Ausrüstungen Equipment [anki:play:a:0]
Auffahrt [anki:play:q:0]	Die Auffahrt , Die Einfahrten Driveway [anki:play:a:0]
Griff [anki:play:q:0]	Der Griff , Die Griffe Grip [anki:play:a:0]
Asche [anki:play:q:0]	Die Asche , Die Asche Ash [anki:play:a:0]
Fan [anki:play:q:0]	Der Fan , Die Fans Fan [anki:play:a:0]
Meinung [anki:play:q:0]	Die Meinung , Die Meinungen Opinion [anki:play:a:0]
Daten [anki:play:q:0]	Die Daten , Die Daten Data [anki:play:a:0]
Verbindung [anki:play:q:0]	Die Verbindung , Die Verbindungen Connection [anki:play:a:0]
Trick [anki:play:q:0]	Der Trick , Die Tricks Trick [anki:play:a:0]
Mysterium [anki:play:q:0]	Das Mysterium , Die Geheimnisse Mystery [anki:play:a:0]
Periode [anki:play:q:0]	Die Periode , Die Perioden Period [anki:play:a:0]
Schreiben [anki:play:q:0]	Das Schreiben , Die Schriften Writing [anki:play:a:0]
Horror [anki:play:q:0]	Der Horror , Die Schrecken Horror [anki:play:a:0]
Süßigkeit [anki:play:q:0]	Die Süßigkeit , Die Bonbons Candy [anki:play:a:0]
Bitch [anki:play:q:0]	Die Bitch , Die Hündinnen Bitch [anki:play:a:0]
Gesundheit [anki:play:q:0]	Die Gesundheit , Die Healths Health [anki:play:a:0]
Geschäftsführer [anki:play:q:0]	Der Geschäftsführer , Die Manager Manager [anki:play:a:0]
Höhe [anki:play:q:0]	Die Höhe , Die Höhen Height [anki:play:a:0]
Erscheinung [anki:play:q:0]	Die Erscheinung , Die Erscheinungen Appearance [anki:play:a:0]
Seufzer [anki:play:q:0]	Der Seufzer , Die Sighes Sigh [anki:play:a:0]
Kleidung [anki:play:q:0]	Die Kleidung , Die Tücher Cloth [anki:play:a:0]
Reaktion [anki:play:q:0]	Die Reaktion , Die Reaktionen Reaction [anki:play:a:0]
Quelle [anki:play:q:0]	Die Quelle , Die Quellen Source [anki:play:a:0]
Ich [anki:play:q:0]	Das Ich , Die Selfs Self [anki:play:a:0]
Pistole [anki:play:q:0]	Die Pistole , Die Pistolen Pistol [anki:play:a:0]
Flughafen [anki:play:q:0]	Der Flughafen , Die Flughäfen Airport [anki:play:a:0]
Held [anki:play:q:0]	Der Held , Die Helden Hero [anki:play:a:0]
Versprechen [anki:play:q:0]	Das Versprechen , Die Versprechen Promise [anki:play:a:0]
Bogen [anki:play:q:0]	Der Bogen , Die Bögen Bow [anki:play:a:0]
Zelt [anki:play:q:0]	Das Zelt , Die Zelte Tent [anki:play:a:0]
Messestand [anki:play:q:0]	Der Messestand , Die Stände Booth [anki:play:a:0]
TShirt [anki:play:q:0]	Das TShirt , Die TShirts TShirt [anki:play:a:0]
Teppich [anki:play:q:0]	Der Teppich , Die Teppiche Carpet [anki:play:a:0]
Keller [anki:play:q:0]	Der Keller , Die Keller Basement [anki:play:a:0]
Freundin [anki:play:q:0]	Die Freundin , Die Freundinnen Girlfriend [anki:play:a:0]
Bart [anki:play:q:0]	Der Bart , Die Bärte Beard [anki:play:a:0]
Bildschirm [anki:play:q:0]	Der Bildschirm , Die Anzeigen Display [anki:play:a:0]
Signal [anki:play:q:0]	Das Signal , Die Signale Signal [anki:play:a:0]
Diener [anki:play:q:0]	Der Diener , Die Diener Servant [anki:play:a:0]
Flüstern [anki:play:q:0]	Das Flüstern , Das Flüstern Whisper [anki:play:a:0]
Zweifel [anki:play:q:0]	Der Zweifel , Die Zweifel Doubt [anki:play:a:0]
Konto [anki:play:q:0]	Das Konto , Die Accounts Account [anki:play:a:0]
Magie [anki:play:q:0]	Die Magie , Die Magie Magic [anki:play:a:0]
Hank [anki:play:q:0]	Die Hank , Die Stränge Hank [anki:play:a:0]
Glied [anki:play:q:0]	Das Glied , Die Schenkel Limb [anki:play:a:0]
Bastard [anki:play:q:0]	Der Bastard , Die Bastarde Bastard [anki:play:a:0]
Schädel [anki:play:q:0]	Der Schädel , Die Schädel Skull [anki:play:a:0]
Kragen [anki:play:q:0]	Der Kragen , Die Kragen Collar [anki:play:a:0]
Horn [anki:play:q:0]	Das Horn , Die Hörner Horn [anki:play:a:0]
Eiche [anki:play:q:0]	Die Eiche , Die Eichen Oak [anki:play:a:0]
Knöchel [anki:play:q:0]	Der Knöchel , Die Knöchel Ankle [anki:play:a:0]
Puppe [anki:play:q:0]	Die Puppe , Die Puppen Doll [anki:play:a:0]
Sandwich [anki:play:q:0]	Das Sandwich , Die Sandwiches Sandwich [anki:play:a:0]
Rotkehlchen [anki:play:q:0]	Das Rotkehlchen , Die Rotkehlchen Robin [anki:play:a:0]
Justiz [anki:play:q:0]	Die Justiz , Die Richter Justice [anki:play:a:0]
Stolz [anki:play:q:0]	Der Stolz , Die Rudel Pride [anki:play:a:0]
Jugend [anki:play:q:0]	Die Jugend , Die Jugendlichen Youth [anki:play:a:0]
Sekretär [anki:play:q:0]	Der Sekretär , Die Sekretäre Secretary [anki:play:a:0]
Forschung [anki:play:q:0]	Die Forschung , Die Forschungen Research [anki:play:a:0]
Sport [anki:play:q:0]	Der Sport , Die Sport Sport [anki:play:a:0]
Aufgabe [anki:play:q:0]	Die Aufgabe , Die Aufgaben Task [anki:play:a:0]
Zuschuss [anki:play:q:0]	Der Zuschuss , Die Zuschüsse Grant [anki:play:a:0]
Sheriff [anki:play:q:0]	Der Sheriff , Die Sheriffs Sheriff [anki:play:a:0]
Mitternachts [anki:play:q:0]	Die Mitternachts , Die Mitternächte Midnight [anki:play:a:0]
Chip [anki:play:q:0]	Der Chip , Die Chips Chip [anki:play:a:0]
Theorie [anki:play:q:0]	Die Theorie , Theorien Theory [anki:play:a:0]
Wecker [anki:play:q:0]	Den Wecker , Die Alarme Alarm [anki:play:a:0]
Sammlung [anki:play:q:0]	Die Sammlung , Die Sammlungen Collection [anki:play:a:0]
Kreuz [anki:play:q:0]	Das Kreuz , Die Kreuze Cross [anki:play:a:0]
Generation [anki:play:q:0]	Die Generation , Die Generationen Generation [anki:play:a:0]
Autorität [anki:play:q:0]	Die Autorität , Die Behörden Authority [anki:play:a:0]
Perle [anki:play:q:0]	Die Perle , Die Perlen Pearl [anki:play:a:0]
Toilette [anki:play:q:0]	Die Toilette , Die Toiletten Toilet [anki:play:a:0]
Mörder [anki:play:q:0]	Der Mörder , Die Mörder Killer [anki:play:a:0]
Werkzeug [anki:play:q:0]	Das Werkzeug , Die Werkzeuge Tool [anki:play:a:0]
Medizin [anki:play:q:0]	Die Medizin , Die Medikamente Medicine [anki:play:a:0]
Zucker [anki:play:q:0]	Der Zucker , Die Zucker Sugar [anki:play:a:0]
Prinzessin [anki:play:q:0]	Die Prinzessin , Die Prinzessinnen Princess [anki:play:a:0]
Argument [anki:play:q:0]	Das Argument , Die Argumente Argument [anki:play:a:0]
Klippe [anki:play:q:0]	Die Klippe , Die Klippen Cliff [anki:play:a:0]
Kristall [anki:play:q:0]	Der Kristall , Die Kristalle Crystal [anki:play:a:0]
Bohne [anki:play:q:0]	Die Bohne , Die Bohnen Bean [anki:play:a:0]
Käfig [anki:play:q:0]	Der Käfig , Die Käfige Cage [anki:play:a:0]
Schokolade [anki:play:q:0]	Die Schokolade , Die Pralinen Chocolate [anki:play:a:0]
Jahrzehnt [anki:play:q:0]	Das Jahrzehnt , Die Jahrzehnte Decade [anki:play:a:0]
Bedeutung [anki:play:q:0]	Die Bedeutung , Die Bedeutungen Meaning [anki:play:a:0]
Getriebe [anki:play:q:0]	Das Getriebe , Die Zahnräder Gear [anki:play:a:0]
Koffer [anki:play:q:0]	Der Koffer , Die Koffer Suitcase [anki:play:a:0]
Operation [anki:play:q:0]	Die Operation , Die Operationen Operation [anki:play:a:0]
Version [anki:play:q:0]	Die Version , Fassungen Version [anki:play:a:0]
Gefangene [anki:play:q:0]	Der Gefangene , Die Gefangenen Prisoner [anki:play:a:0]
Match [anki:play:q:0]	Das Match , Die Spiele Match [anki:play:a:0]
Burg [anki:play:q:0]	Die Burg , Die Schlösser Castle [anki:play:a:0]
Ansturm [anki:play:q:0]	Der Ansturm , Die Binsen Rush [anki:play:a:0]
Fahrspur [anki:play:q:0]	Die Fahrspur , Die Bahnen Lane [anki:play:a:0]
Bekleidung [anki:play:q:0]	Die Bekleidung , Die Garnituren Clothing [anki:play:a:0]
Pol [anki:play:q:0]	Der Pol , Die Pole Pole [anki:play:a:0]
Freiheit [anki:play:q:0]	Die Freiheit , Die Freiheiten Freedom [anki:play:a:0]
Können [anki:play:q:0]	Das Können , Die Fähigkeiten Skill [anki:play:a:0]
Leidenschaft [anki:play:q:0]	Die Leidenschaft , Die Leidenschaften Passion [anki:play:a:0]
Aktivität [anki:play:q:0]	Die Aktivität , Die Aktivitäten Activity [anki:play:a:0]
Teufel [anki:play:q:0]	Zum Teufel , Die Fickt Fuck [anki:play:a:0]
Platform [anki:play:q:0]	Die Platform , Die Plattformen Platform [anki:play:a:0]
Salz [anki:play:q:0]	Das Salz , Die Salze Salt [anki:play:a:0]
Fahrrad [anki:play:q:0]	Das Fahrrad , Die Fahrräder Bike [anki:play:a:0]
Begleiter [anki:play:q:0]	Der Begleiter , Die Gefährten Companion [anki:play:a:0]
Schicksal [anki:play:q:0]	Das Schicksal , Die Schicksale Fate [anki:play:a:0]
Versorgung [anki:play:q:0]	Die Versorgung , Die Lieferungen Supply [anki:play:a:0]
Wal [anki:play:q:0]	Der Wal , Die Wale Whale [anki:play:a:0]
Schwein [anki:play:q:0]	Das Schwein , Die Schweine Pig [anki:play:a:0]
Hase [anki:play:q:0]	Der Hase , Die Hasen Rabbit [anki:play:a:0]
Gang [anki:play:q:0]	Der Gang , Die Gänge Aisle [anki:play:a:0]
Helm [anki:play:q:0]	Der Helm , Die Helme Helmet [anki:play:a:0]
Respekt [anki:play:q:0]	Der Respekt , Die Beziehung Respect [anki:play:a:0]
Aufregung [anki:play:q:0]	Die Aufregung , Die Aufregungen Excitement [anki:play:a:0]
Lobby [anki:play:q:0]	Die Lobby , Die Lobbys Lobby [anki:play:a:0]
Freund [anki:play:q:0]	Der Freund , Die Freunde Boyfriend [anki:play:a:0]
Fell [anki:play:q:0]	Das Fell , Die Felle Fur [anki:play:a:0]
Bereich [anki:play:q:0]	Der Bereich , Die Bereiche Range, área, anel, âmbito, campo, domínio, ramo, alcance, gama [anki:play:a:0]
Dick [anki:play:q:0]	Die Dick , Die Schwänze Dick [anki:play:a:0]
Code [anki:play:q:0]	Der Code , Die Codes Code [anki:play:a:0]
Kapitel [anki:play:q:0]	Das Kapitel , Die Kapitel Chapter [anki:play:a:0]
Reflexion [anki:play:q:0]	Die Reflexion , Die Reflexionen Reflection [anki:play:a:0]
Kabinett [anki:play:q:0]	Das Kabinett , Die Schränke Cabinet [anki:play:a:0]
Spielzeug [anki:play:q:0]	Das Spielzeug , Die Spielzeuge Toy [anki:play:a:0]
Baseball [anki:play:q:0]	Die Baseball , The Baseballs Baseball [anki:play:a:0]
Führung [anki:play:q:0]	Die Führung , Die Zuleitungen Lead [anki:play:a:0]
Summe [anki:play:q:0]	Die Summe , Die Beträge Amount [anki:play:a:0]
Nerv [anki:play:q:0]	Der Nerv , Die Nerven Nerve [anki:play:a:0]
Schrecken [anki:play:q:0]	Der Schrecken , Die Schrecken Terror [anki:play:a:0]
Pullover [anki:play:q:0]	Der Pullover , Die Pullover Sweater [anki:play:a:0]
Qualität [anki:play:q:0]	Die Qualität , Die Qualitäten Quality [anki:play:a:0]
Jäger [anki:play:q:0]	Der Jäger , Die Jäger Hunter [anki:play:a:0]
Buster [anki:play:q:0]	Die Buster , The Busters Buster [anki:play:a:0]
Baumwolle [anki:play:q:0]	Die Baumwolle , Die Baumwollstoffe Cotton [anki:play:a:0]
Wachtmeister [anki:play:q:0]	Der Wachtmeister , Die Feldwebel Sergeant [anki:play:a:0]
Kredit [anki:play:q:0]	Der Kredit , Die Kredite Credit [anki:play:a:0]
Schlag [anki:play:q:0]	Der Schlag , Die Schläge golpe, pancada [anki:play:a:0]
Bedrohung [anki:play:q:0]	Die Bedrohung , Die Drohungen Threat [anki:play:a:0]
Erfolg [anki:play:q:0]	Der Erfolg , Erfolge Success [anki:play:a:0]
Vorabend [anki:play:q:0]	Dem Vorabend , Die Eves Eve [anki:play:a:0]
Pfanne [anki:play:q:0]	Die Pfanne , Die Pfannen Pan [anki:play:a:0]
Angestellte [anki:play:q:0]	Der Angestellte , Die Schreiber Clerk [anki:play:a:0]
Titel [anki:play:q:0]	Den Titel , Die Titel Title [anki:play:a:0]
Messgerät [anki:play:q:0]	Das Messgerät , Die Zähler Meter [anki:play:a:0]
Schande [anki:play:q:0]	Die Schande , Die Schande Shame [anki:play:a:0]
Nadel [anki:play:q:0]	Die Nadel , Die Nadeln Needle [anki:play:a:0]
Lunge [anki:play:q:0]	Die Lunge , Die Lungen Lung [anki:play:a:0]
Krieger [anki:play:q:0]	Der Krieger , Die Krieger Warrior [anki:play:a:0]
Umstand [anki:play:q:0]	Der Umstand , Die Umstände Circumstance [anki:play:a:0]
Studio [anki:play:q:0]	Das Studio , Die Studios Studio [anki:play:a:0]
Panik [anki:play:q:0]	Die Panik , Die Panik Panic [anki:play:a:0]
Mangel [anki:play:q:0]	Der Mangel , Das Fehlt Lack [anki:play:a:0]
Bauer [anki:play:q:0]	Der Bauer , Die Bauern Farmer [anki:play:a:0]
Akzent [anki:play:q:0]	Der Akzent , Die Akzente Accent [anki:play:a:0]
Bombe [anki:play:q:0]	Die Bombe , Die Bomben Bomb [anki:play:a:0]
Platte [anki:play:q:0]	Die Platte , Die Paneele Panel [anki:play:a:0]
Fähigkeit [anki:play:q:0]	Die Fähigkeit , Die Das Können Ability [anki:play:a:0]
Sieger [anki:play:q:0]	Der Sieger , Die Sieger Victor [anki:play:a:0]
Feder [anki:play:q:0]	Die Feder , Die Federn Feather [anki:play:a:0]
Oma [anki:play:q:0]	Die Oma , Die Großmütter Grandma [anki:play:a:0]
Glühen [anki:play:q:0]	Das Glühen , Die Glüht Glow [anki:play:a:0]
Verhalten [anki:play:q:0]	Das Verhalten , Die Verhaltensweisen Behavior [anki:play:a:0]
Durchgang [anki:play:q:0]	Der Durchgang , Die Durchgänge Passage [anki:play:a:0]
Slave [anki:play:q:0]	Die Slave , Die Sklaven Slave [anki:play:a:0]
Leutnant [anki:play:q:0]	Der Leutnant , Die Leutnants Lieutenant [anki:play:a:0]
Wärme [anki:play:q:0]	Die Wärme , Die Warmths Warmth [anki:play:a:0]
Eindruck [anki:play:q:0]	Der Eindruck , Die Eindrücke Impression [anki:play:a:0]
Maurer [anki:play:q:0]	Der Maurer , Die Maurer Mason [anki:play:a:0]
Braut [anki:play:q:0]	Die Braut , Die Bräute Bride [anki:play:a:0]
Paket [anki:play:q:0]	Das Paket , Die Pakete Package [anki:play:a:0]
Nebel [anki:play:q:0]	Der Nebel , Die Nebel Fog [anki:play:a:0]
Gehen [anki:play:q:0]	Das Gehen , Die Wanderungen Walking [anki:play:a:0]
Balance [anki:play:q:0]	Die Balance , Die Salden Balance [anki:play:a:0]
Socke [anki:play:q:0]	Die Socke , Die Socken Sock [anki:play:a:0]
Roboter [anki:play:q:0]	Der Roboter , Die Roboter Robot [anki:play:a:0]
Kartoffel [anki:play:q:0]	Die Kartoffel , Die Kartoffeln Potato [anki:play:a:0]
Gegenstand [anki:play:q:0]	Der Gegenstand , Die Gegenstände Item [anki:play:a:0]
Diamant [anki:play:q:0]	Der Diamant , Die Diamanten Diamond [anki:play:a:0]
Leiche [anki:play:q:0]	Die Leiche , Die Leichen Corpse [anki:play:a:0]
Erklärung [anki:play:q:0]	Die Erklärung , Die Erklärungen Explanation [anki:play:a:0]
Struktur [anki:play:q:0]	Die Struktur , Die Strukturen Structure [anki:play:a:0]
Ausgang [anki:play:q:0]	Der Ausgang , Die Ausgänge Exit [anki:play:a:0]
Pad [anki:play:q:0]	Das Pad , Die Pads Pad [anki:play:a:0]
Herd [anki:play:q:0]	Der Herd , Die Öfen Stove [anki:play:a:0]
Blaue [anki:play:q:0]	Das Blaue , Der Blues Blue [anki:play:a:0]
Amerikaner [anki:play:q:0]	Die Amerikaner , Die Amerikaner American [anki:play:a:0]
Rubin [anki:play:q:0]	Der Rubin , Die Rubinen Ruby [anki:play:a:0]
Grube [anki:play:q:0]	Die Grube , Die Gruben Pit [anki:play:a:0]
Oberst [anki:play:q:0]	Der Oberst , Die Obersten Colonel [anki:play:a:0]
Dock [anki:play:q:0]	Das Dock , Die Docks Dock [anki:play:a:0]
Bach [anki:play:q:0]	Der Bach , Die Bäche Creek [anki:play:a:0]
Ratschlag [anki:play:q:0]	Der Ratschlag , Die Ratschläge Advice [anki:play:a:0]
Tourist [anki:play:q:0]	Der Tourist , Die Touristen Tourist [anki:play:a:0]
Trauer [anki:play:q:0]	Die Trauer , Die Schmerzen Grief [anki:play:a:0]
Verteidigung [anki:play:q:0]	Die Verteidigung , Die Abwehrkräfte Defense [anki:play:a:0]
Biss [anki:play:q:0]	Der Biss , Die Bisse Bite [anki:play:a:0]
Museum [anki:play:q:0]	Das Museum , Die Museen Museum [anki:play:a:0]
Gunst [anki:play:q:0]	Die Gunst , Wohltaten Favor [anki:play:a:0]
Dekan [anki:play:q:0]	Der Dekan , Die Dekane Dean [anki:play:a:0]
Wert [anki:play:q:0]	Der Wert , Die Werte Value [anki:play:a:0]
Marsch [anki:play:q:0]	Der Marsch , Die Märsche March [anki:play:a:0]
Anwesen [anki:play:q:0]	Das Anwesen , Die Stände Estate [anki:play:a:0]
Poet [anki:play:q:0]	Der Poet , Die Dichter Poet [anki:play:a:0]
Palast [anki:play:q:0]	Der Palast , Die Paläste Palace [anki:play:a:0]
Suppe [anki:play:q:0]	Die Suppe , Die Suppen Soup [anki:play:a:0]
Nation [anki:play:q:0]	Die Nation , Die Nationen Nation [anki:play:a:0]
Gefäss [anki:play:q:0]	Das Gefäss , Die Gläser Jar [anki:play:a:0]
Ständige [anki:play:q:0]	Der Ständige , Die Tabellenführung Standing [anki:play:a:0]
Sack [anki:play:q:0]	Der Sack , Die Säcke Sack [anki:play:a:0]
Dämon [anki:play:q:0]	Der Dämon , Die Dämonen Demon [anki:play:a:0]
Konferenz [anki:play:q:0]	Die Konferenz , Die Konferenzen Conference [anki:play:a:0]
Saft [anki:play:q:0]	Der Saft , Die Säfte Juice [anki:play:a:0]
Verantwortung [anki:play:q:0]	Die Verantwortung , Die Verantwortungen Responsibility [anki:play:a:0]
Pinsel [anki:play:q:0]	Der Pinsel , Die Bürsten Brush [anki:play:a:0]
Route [anki:play:q:0]	Die Route , Die Strecken Route [anki:play:a:0]
Käse [anki:play:q:0]	Der Käse , Die Käse Cheese [anki:play:a:0]
Haube [anki:play:q:0]	Die Haube , Die Hauben Hood [anki:play:a:0]
Ente [anki:play:q:0]	Die Ente , Die Ente Duck [anki:play:a:0]
Heilige [anki:play:q:0]	Der Heilige , Die Heiligen Saint [anki:play:a:0]
Pass [anki:play:q:0]	Der Pass , Die Pässe Pass [anki:play:a:0]
Ziel [anki:play:q:0]	Das Ziel , Die Ziele Target [anki:play:a:0]
Orange [anki:play:q:0]	Die Orange , Die Orangen Orange [anki:play:a:0]
Kultur [anki:play:q:0]	Die Kultur , Die Kulturen Culture [anki:play:a:0]
Kommandant [anki:play:q:0]	Der Kommandant , Die Kommandeure Commander [anki:play:a:0]
Haken [anki:play:q:0]	Der Haken , Die Haken Hook [anki:play:a:0]
Training [anki:play:q:0]	Das Training , Die Trainings Training [anki:play:a:0]
Suche [anki:play:q:0]	Die Suche , Die Suche Search [anki:play:a:0]
Münze [anki:play:q:0]	Die Münze , Die Münzen Coin [anki:play:a:0]
Vorteil [anki:play:q:0]	Der Vorteil , Die Vorteile Advantage [anki:play:a:0]
Austausch [anki:play:q:0]	Der Austausch , Die Börsen Exchange [anki:play:a:0]
Fiktion [anki:play:q:0]	Die Fiktion , Fiktionen Fiction [anki:play:a:0]
Teich [anki:play:q:0]	Der Teich , Die Teiche Pond [anki:play:a:0]
Assistent [anki:play:q:0]	Der Assistent , Die Assistenten Assistant [anki:play:a:0]
Design [anki:play:q:0]	Das Design , Die Entwürfe Design [anki:play:a:0]
Angel [anki:play:q:0]	Die Angel , Die Fishings Fishing [anki:play:a:0]
Piste [anki:play:q:0]	Die Piste , Die Pisten Slope [anki:play:a:0]
Graf [anki:play:q:0]	Der Graf , Die Grafen Earl [anki:play:a:0]
Kellner [anki:play:q:0]	Der Kellner , Die Kellner Waiter [anki:play:a:0]
Mittel [anki:play:q:0]	das Mittel , Die Mittel a forma, o meio, o remédio [anki:play:a:0]
Leiter [anki:play:q:0]	Die Leiter , Die Leitern Ladder [anki:play:a:0]
Kurve [anki:play:q:0]	Die Kurve , Die Kurven Curve [anki:play:a:0]
Volumen [anki:play:q:0]	Das Volumen , Die Volumina Volume [anki:play:a:0]
Risiko [anki:play:q:0]	Das Risiko , Die Risiken Risk [anki:play:a:0]
Albtraum [anki:play:q:0]	Der Albtraum , Die Alpträume Nightmare [anki:play:a:0]
Existenz [anki:play:q:0]	Die Existenz , Die Existenzen Existence [anki:play:a:0]
Spur [anki:play:q:0]	Die Spur , Die Spuren Trace [anki:play:a:0]
Krankheit [anki:play:q:0]	Die Krankheit , Die Krankheiten Disease [anki:play:a:0]
Unterstützung [anki:play:q:0]	Die Unterstützung , Die Stützen Support [anki:play:a:0]
Zeuge [anki:play:q:0]	Der Zeuge , Die Zeugen Witness [anki:play:a:0]
Aktie [anki:play:q:0]	Die Aktie , Die Bestände Stock [anki:play:a:0]
Gerät [anki:play:q:0]	Das Gerät , Die Vorrichtungen Device [anki:play:a:0]
Landschaft [anki:play:q:0]	Die Landschaft , Die Landschaften Landscape [anki:play:a:0]
Urlaub [anki:play:q:0]	Der Urlaub , Die Feiertage Holiday [anki:play:a:0]
Ass [anki:play:q:0]	Das Ass , Die Asse Ace [anki:play:a:0]
Klavier [anki:play:q:0]	Das Klavier , Die Klaviere Piano [anki:play:a:0]
Eingeweide [anki:play:q:0]	Die Eingeweide , Die Eingeweide Gut [anki:play:a:0]
Talent [anki:play:q:0]	Das Talent , Die Talente Talent [anki:play:a:0]
Phantasie [anki:play:q:0]	Die Phantasie , Die Vorstellungen Imagination [anki:play:a:0]
Schwarze [anki:play:q:0]	Die Schwarze , Die Schwarzen Black [anki:play:a:0]
Reed [anki:play:q:0]	Der Reed , Das Schilf Reed [anki:play:a:0]
Hinweis [anki:play:q:0]	Der Hinweis , Die Hinweise Hint [anki:play:a:0]
Wanderer [anki:play:q:0]	Der Wanderer , Die Wanderer Walker [anki:play:a:0]
Interview [anki:play:q:0]	Das Interview , Die Interviews Interview [anki:play:a:0]
Ansatz [anki:play:q:0]	Der Ansatz , Die Ansätze Approach [anki:play:a:0]
Narbe [anki:play:q:0]	Die Narbe , Die Narben Scar [anki:play:a:0]
Mode [anki:play:q:0]	Die Mode , Die Mode Fashion [anki:play:a:0]
Kanal [anki:play:q:0]	Der Kanal , Die Kanäle Channel [anki:play:a:0]
Tritt [anki:play:q:0]	Die Tritt , Die Schritte Footstep [anki:play:a:0]
Aufnehmer [anki:play:q:0]	Der Aufnehmer , Die Pickups Pickup [anki:play:a:0]
Habicht [anki:play:q:0]	Der Habicht , Die Falken Hawk [anki:play:a:0]
Anhänger [anki:play:q:0]	Der Anhänger , Die Anhänger Trailer [anki:play:a:0]
Statue [anki:play:q:0]	Die Statue , Die Statuen Statue [anki:play:a:0]
Pille [anki:play:q:0]	Die Pille , Die Pillen Pill [anki:play:a:0]
Käfer [anki:play:q:0]	Der Käfer , Die Bugs Bug [anki:play:a:0]
Eimer [anki:play:q:0]	Der Eimer , Die Eimer Bucket [anki:play:a:0]
Arten [anki:play:q:0]	Die Arten , Die Specieses Species [anki:play:a:0]
Kolumne [anki:play:q:0]	Die Kolumne , Die Spalten Column [anki:play:a:0]
Schaden [anki:play:q:0]	Der Schaden , Die Schäden Damage [anki:play:a:0]
Instrument [anki:play:q:0]	Das Instrument , Die Instrumente Instrument [anki:play:a:0]
Schicht [anki:play:q:0]	Die Schicht , Die Schichten Layer [anki:play:a:0]
Streifen [anki:play:q:0]	Der Streifen , Die Streifen Strip [anki:play:a:0]
Rippe [anki:play:q:0]	Die Rippe , Die Rippen Rib [anki:play:a:0]
Notebook [anki:play:q:0]	Das Notebook , Die Notizbücher Notebook [anki:play:a:0]
Mais [anki:play:q:0]	Der Mais , Die Hühneraugen Corn [anki:play:a:0]
Angebot [anki:play:q:0]	Das Angebot , Die Angebote Offer [anki:play:a:0]
Zeichnung [anki:play:q:0]	Die Zeichnung , Die Zeichnungen Drawing [anki:play:a:0]
Aussage [anki:play:q:0]	Die Aussage , Die Aussagen Statement [anki:play:a:0]
Intelligenz [anki:play:q:0]	Die Intelligenz , Die Intelligenzen Intelligence [anki:play:a:0]
Entschuldigung [anki:play:q:0]	Die Entschuldigung , Die Entschuldigungen Excuse [anki:play:a:0]
Urheberrechts [anki:play:q:0]	Der Urheberrechts , Die Urheberrechte Copyright [anki:play:a:0]
Stange [anki:play:q:0]	Die Stange , Die Stäbe Rod [anki:play:a:0]
Fantasie [anki:play:q:0]	Die Fantasie , Die Phantasien Fantasy [anki:play:a:0]
Neugier [anki:play:q:0]	Die Neugier , Die Kuriositäten Curiosity [anki:play:a:0]
Grenze [anki:play:q:0]	Die Grenze , Die Grenzen Border [anki:play:a:0]
Poesie [anki:play:q:0]	Die Poesie , Die Dichtungen Poetry [anki:play:a:0]
Firma [anki:play:q:0]	Die Firma , Die Firmen Firm [anki:play:a:0]
Handvoll [anki:play:q:0]	Die Handvoll , Die Hände Voll Handful [anki:play:a:0]
China [anki:play:q:0]	Die China , Die Chinas China [anki:play:a:0]
Franzosen [anki:play:q:0]	Die Franzosen , Die Frenches French [anki:play:a:0]
Durchschnitt [anki:play:q:0]	der Durchschnitt , Die Durchschnitte Mean [anki:play:a:0]
Reh [anki:play:q:0]	Das Reh , Die Hirsche Deer [anki:play:a:0]
Schiene [anki:play:q:0]	Die Schiene , Die Schienen Rail [anki:play:a:0]
Mut [anki:play:q:0]	Der Mut , Die Courages Courage [anki:play:a:0]
Ankunft [anki:play:q:0]	Die Ankunft , Die Ankünfte Arrival [anki:play:a:0]
Wunsch [anki:play:q:0]	Der Wunsch , Wünsche Wish [anki:play:a:0]
Grat [anki:play:q:0]	Der Grat , Die Grate Ridge [anki:play:a:0]
Idiot [anki:play:q:0]	Der Idiot , Die Idioten Idiot [anki:play:a:0]
Bulle [anki:play:q:0]	Der Bulle , Die Bullen Bull [anki:play:a:0]
Saat [anki:play:q:0]	Die Saat , Die Samen Seed [anki:play:a:0]
Fortschritt [anki:play:q:0]	Der Fortschritt , Die Fortschritte Progress [anki:play:a:0]
Bürger [anki:play:q:0]	Der Bürger , Die Bürger Citizen [anki:play:a:0]
Protokoll [anki:play:q:0]	Das Protokoll , Die Protokolle Log [anki:play:a:0]
Geduld [anki:play:q:0]	Die Geduld , Die Patiencen Patience [anki:play:a:0]
Fledermaus [anki:play:q:0]	Die Fledermaus , Die Fledermäuse Bat [anki:play:a:0]
Fußball [anki:play:q:0]	Der Fußball , Die Fußbälle Football [anki:play:a:0]
Routine [anki:play:q:0]	Die Routine , Die Routinen Routine [anki:play:a:0]
Explosion [anki:play:q:0]	Die Explosion , Die Explosionen Explosion [anki:play:a:0]
Inhalt [anki:play:q:0]	Der Inhalt , Die Inhalte Content [anki:play:a:0]
Wissenschaftler [anki:play:q:0]	Der Wissenschaftler , Die Wissenschaftler Scientist [anki:play:a:0]
Versagen [anki:play:q:0]	Das Versagen , Die Ausfälle Failure [anki:play:a:0]
Sünde [anki:play:q:0]	Die Sünde , Die Sünden Sin [anki:play:a:0]
Hintern [anki:play:q:0]	Der Hintern , Die Füße Butt [anki:play:a:0]
Verwirrung [anki:play:q:0]	Die Verwirrung , Die Verwirrungen Confusion [anki:play:a:0]
Verständnis [anki:play:q:0]	Das Verständnis , Die Verständnisse Understanding [anki:play:a:0]
Handel [anki:play:q:0]	Der Handel , Das Handwerk Trade [anki:play:a:0]
Kühlschrank [anki:play:q:0]	Der Kühlschrank , Die Kühlschränke Refrigerator [anki:play:a:0]
Taschenlampe [anki:play:q:0]	Die Taschenlampe , Die Taschenlampen Flashlight [anki:play:a:0]
Internet [anki:play:q:0]	Das Internet , Die Netze Net [anki:play:a:0]
Seemann [anki:play:q:0]	Der Seemann , Die Matrosen Sailor [anki:play:a:0]
Attitüde [anki:play:q:0]	Die Attitüde , Die Haltungen Attitude [anki:play:a:0]
Schuld [anki:play:q:0]	Die Schuld , Die Schulde Guilt [anki:play:a:0]
Sip [anki:play:q:0]	Die Sip , Sips Sip [anki:play:a:0]
Keks [anki:play:q:0]	Der Keks , Die Kekse Cookie [anki:play:a:0]
Flucht [anki:play:q:0]	Die Flucht , Die Fluchten Escape [anki:play:a:0]
Anleitung [anki:play:q:0]	Die Anleitung , Die Anleitungen Instruction [anki:play:a:0]
Gewebe [anki:play:q:0]	Das Gewebe , Die Stoffe Fabric [anki:play:a:0]
Marmor [anki:play:q:0]	Der Marmor , Die Murmeln Marble [anki:play:a:0]
Dämmerung [anki:play:q:0]	Die Dämmerung , Die Dämmerungen Dusk [anki:play:a:0]
Hütte [anki:play:q:0]	Die Hütte , Die Ferienhäuser Cottage [anki:play:a:0]
Affe [anki:play:q:0]	Der Affe , Die Affen Monkey [anki:play:a:0]
Makeup [anki:play:q:0]	Das Makeup , Die MakeUps Makeup [anki:play:a:0]
Doc [anki:play:q:0]	Die Doc , Die Docs Doc [anki:play:a:0]
Bluse [anki:play:q:0]	Die Bluse , Die Blusen Blouse [anki:play:a:0]
Rhythmus [anki:play:q:0]	Der Rhythmus , Die Rhythmen Rhythm [anki:play:a:0]
Dampf [anki:play:q:0]	Der Dampf , Die Dämpfe Steam [anki:play:a:0]
Bleistift [anki:play:q:0]	Der Bleistift , Die Stifte Pencil [anki:play:a:0]
Koch [anki:play:q:0]	Der Koch , Die Köche Cook [anki:play:a:0]
Flagge [anki:play:q:0]	Die Flagge , Die Fahnen Flag [anki:play:a:0]
Trainer [anki:play:q:0]	Der Trainer , Die Trainer Coach [anki:play:a:0]
Schaukel [anki:play:q:0]	Die Schaukel , Die Schaukeln Swing [anki:play:a:0]
Lautsprecher [anki:play:q:0]	Der Lautsprecher , Die Lautsprecher Speaker [anki:play:a:0]
Bolzen [anki:play:q:0]	Der Bolzen , Die Bolzen Bolt [anki:play:a:0]
Fett [anki:play:q:0]	Das Fett , Die Fette Fat [anki:play:a:0]
Klopf [anki:play:q:0]	Die Klopf , Die Schläge Knock [anki:play:a:0]
Zauber [anki:play:q:0]	Der Zauber , Die Zaubersprüche Spell [anki:play:a:0]
Runde [anki:play:q:0]	Die Runde , Die Runden Round [anki:play:a:0]
Strohhalm [anki:play:q:0]	Der Strohhalm , Die Halme Straw [anki:play:a:0]
Luke [anki:play:q:0]	Die Luke , Die Luken Hatch [anki:play:a:0]
Gabel [anki:play:q:0]	Die Gabel , Die Gabeln Fork [anki:play:a:0]
Böse [anki:play:q:0]	Das Böse , Die Übel Evil [anki:play:a:0]
Relative [anki:play:q:0]	Die Relative , Die Verwandten Relative [anki:play:a:0]
Hexe [anki:play:q:0]	Die Hexe , Die Hexen Witch [anki:play:a:0]
Sensation [anki:play:q:0]	Die Sensation , Die Empfindungen Sensation [anki:play:a:0]
Blase [anki:play:q:0]	Die Blase , Die Blasen Bubble [anki:play:a:0]
Leser [anki:play:q:0]	Der Leser , Die Leser Reader [anki:play:a:0]
Locke [anki:play:q:0]	Die Locke , Die Locken Curl [anki:play:a:0]
Verschiebung [anki:play:q:0]	Die Verschiebung , Die Verschiebungen Shift [anki:play:a:0]
Union [anki:play:q:0]	Die Union , Die Gewerkschaften Union [anki:play:a:0]
Teenager [anki:play:q:0]	Der Teenager , Die Teenager Teenager [anki:play:a:0]
Ebene [anki:play:q:0]	Die Ebene , Die Ebenen Plain [anki:play:a:0]
Kellnerin [anki:play:q:0]	Die Kellnerin , Die Kellnerinnen Waitress [anki:play:a:0]
Gerücht [anki:play:q:0]	Das Gerücht , Gerüchte Rumor [anki:play:a:0]
Schwerkraft [anki:play:q:0]	Die Schwerkraft , Die Gewichte Gravity [anki:play:a:0]
Zuflucht [anki:play:q:0]	Die Zuflucht , Die Unterstände Shelter [anki:play:a:0]
Abenteuer [anki:play:q:0]	Das Abenteuer , Die Abenteuer Adventure [anki:play:a:0]
Löwe [anki:play:q:0]	Der Löwe , Die Löwen Lion [anki:play:a:0]
Wirbelsäule [anki:play:q:0]	Die Wirbelsäule , Die Stacheln Spine [anki:play:a:0]
Tiefe [anki:play:q:0]	Die Tiefe , Die Tiefen Depth [anki:play:a:0]
Reichweite [anki:play:q:0]	Die Reichweite , Die Reichweiten Reach [anki:play:a:0]
Hammer [anki:play:q:0]	Der Hammer , Die Hämmer Hammer [anki:play:a:0]
Bibel [anki:play:q:0]	Die Bibel , Die Bibeln Bible [anki:play:a:0]
Vertrag [anki:play:q:0]	Der Vertrag , Die Verträge Contract [anki:play:a:0]
Dschungel [anki:play:q:0]	Der Dschungel , Die Dschungel Jungle [anki:play:a:0]
Fabrik [anki:play:q:0]	Die Fabrik , Die Fabriken Factory [anki:play:a:0]
Indische [anki:play:q:0]	Die Indische , Die Indianer Indian [anki:play:a:0]
Balkon [anki:play:q:0]	Der Balkon , Die Balkone Balcony [anki:play:a:0]
Reis [anki:play:q:0]	Der Reis , Die Reis Rice [anki:play:a:0]
Knoten [anki:play:q:0]	Der Knoten , Die Knoten Knot [anki:play:a:0]
Kollege [anki:play:q:0]	Der Kollege , Die Kollegen Colleague [anki:play:a:0]
Stare [anki:play:q:0]	Die Stare , Die Blicke Stare [anki:play:a:0]
Motel [anki:play:q:0]	Das Motel , Die Motels Motel [anki:play:a:0]
Liebling [anki:play:q:0]	Der Liebling , Die Lieblinge Darling [anki:play:a:0]
Diskussion [anki:play:q:0]	Die Diskussion , Die Diskussionen Discussion [anki:play:a:0]
Leistung [anki:play:q:0]	Die Leistung , Die Leistungen Performance [anki:play:a:0]
Spannung [anki:play:q:0]	Die Spannung , Die Spannungen Tension [anki:play:a:0]
Text [anki:play:q:0]	Der Text , Die Texte Text [anki:play:a:0]
Mittags [anki:play:q:0]	Die Mittags , Die Noons Noon [anki:play:a:0]
Vene [anki:play:q:0]	Die Vene , Die Venen Vein [anki:play:a:0]
Experte [anki:play:q:0]	Der Experte , Die Experten Expert [anki:play:a:0]
Krebs [anki:play:q:0]	Der Krebs , Die Krebs Cancer [anki:play:a:0]
Fuchs [anki:play:q:0]	Der Fuchs , Die Foxs Fox [anki:play:a:0]
Scheidung [anki:play:q:0]	Die Scheidung , Die Scheidungen Divorce [anki:play:a:0]
Impuls [anki:play:q:0]	Die Impuls , Die Pulse Pulse [anki:play:a:0]
Abwesenheit [anki:play:q:0]	Die Abwesenheit , Die Abwesenheiten Absence [anki:play:a:0]
Gewalt [anki:play:q:0]	Die Gewalt , Die Gewalten Violence [anki:play:a:0]
Humor [anki:play:q:0]	Der Humor , Die Körpersäfte Humor [anki:play:a:0]
Kies [anki:play:q:0]	Der Kies , Die Kiese Gravel [anki:play:a:0]
Schatz [anki:play:q:0]	Der Schatz , Schätze Treasure [anki:play:a:0]
Butter [anki:play:q:0]	Die Butter , Die Butter Butter [anki:play:a:0]
Schalter [anki:play:q:0]	Der Schalter , Die Schalter Switch [anki:play:a:0]
Zigarre [anki:play:q:0]	Die Zigarre , Die Zigarren Cigar [anki:play:a:0]
Leinwand [anki:play:q:0]	Die Leinwand , Die Leinwände Canvas [anki:play:a:0]
Fröhlichkeit [anki:play:q:0]	Die Fröhlichkeit , Die Seligkeiten Happiness [anki:play:a:0]
Schauspieler [anki:play:q:0]	Der Schauspieler , Die Akteure Actor [anki:play:a:0]
Ganze [anki:play:q:0]	Das Ganze , Die Löcher Whole [anki:play:a:0]
Vereinbarung [anki:play:q:0]	Die Vereinbarung , Die Vereinbarungen Arrangement [anki:play:a:0]
Braune [anki:play:q:0]	Die Braune , Die Brauntöne Brown [anki:play:a:0]
Gastgeber [anki:play:q:0]	Der Gastgeber , Die Gastgeber Host [anki:play:a:0]
Farbband [anki:play:q:0]	Das Farbband , Die Bänder Ribbon [anki:play:a:0]
Schal [anki:play:q:0]	Der Schal , Die Schals Scarf [anki:play:a:0]
Skala [anki:play:q:0]	Die Skala , Die Waagen Scale [anki:play:a:0]
Pfeil [anki:play:q:0]	Der Pfeil , Die Pfeile Arrow [anki:play:a:0]
Temperatur [anki:play:q:0]	Die Temperatur , Die Temperaturen Temperature [anki:play:a:0]
Technologie [anki:play:q:0]	Die Technologie , Technologien Technology [anki:play:a:0]
Erlaubnis [anki:play:q:0]	Die Erlaubnis , Die Berechtigungen Permission [anki:play:a:0]
Klaue [anki:play:q:0]	Die Klaue , Die Krallen Claw [anki:play:a:0]
Cowboy [anki:play:q:0]	Der Cowboy , Die Cowboies Cowboy [anki:play:a:0]
Agentur [anki:play:q:0]	Die Agentur , Die Agenturen Agency [anki:play:a:0]
Konstruktion [anki:play:q:0]	Die Konstruktion , Die Konstruktionen Construction [anki:play:a:0]
Jagd [anki:play:q:0]	Das Jagd , Die Jagden Hunting [anki:play:a:0]
Gemüse [anki:play:q:0]	Das Gemüse , Das Gemüse Vegetable [anki:play:a:0]
Hubschrauber [anki:play:q:0]	Der Hubschrauber , Die Hubschrauber Helicopter [anki:play:a:0]
Pat [anki:play:q:0]	Das Pat , Die Streicheleinheiten Pat [anki:play:a:0]
Lücke [anki:play:q:0]	Die Lücke , Die Lücken Gap [anki:play:a:0]
Haustier [anki:play:q:0]	Das Haustier , Die Haustiere Pet [anki:play:a:0]
Ausbildung [anki:play:q:0]	Die Ausbildung , Die Ausbildungen Education [anki:play:a:0]
Einkaufen [anki:play:q:0]	Das Einkaufen , Die Einkäufe Shopping [anki:play:a:0]
Schuppen [anki:play:q:0]	Der Schuppen , Die Schuppen Shed [anki:play:a:0]
Herzog [anki:play:q:0]	Der Herzog , Die Herzöge Duke [anki:play:a:0]
Schrotflinte [anki:play:q:0]	Die Schrotflinte , Die Schrotflinten Shotgun [anki:play:a:0]
Vorstellung [anki:play:q:0]	Die Vorstellung , Die Begriffe Notion [anki:play:a:0]
Gibt [anki:play:q:0]	Es Gibt , Die Hintern Rear [anki:play:a:0]
Zeremonie [anki:play:q:0]	Die Zeremonie , Die Zeremonien Ceremony [anki:play:a:0]
Löffel [anki:play:q:0]	Der Löffel , Die Löffel Spoon [anki:play:a:0]
Wanne [anki:play:q:0]	Die Wanne , Die Wannen Tub [anki:play:a:0]
Iris [anki:play:q:0]	Die Iris , Die Iris Iris [anki:play:a:0]
Absturz [anki:play:q:0]	Der Absturz , Die Abstürze Crash [anki:play:a:0]
Zugriffs [anki:play:q:0]	Die Zugriffs , Die Zugriffe Access [anki:play:a:0]
Schaf [anki:play:q:0]	Das Schaf , Die Schafe Sheep [anki:play:a:0]
Ingenieur [anki:play:q:0]	Der Ingenieur , Die Ingenieure Engineer [anki:play:a:0]
Rumpf [anki:play:q:0]	Der Rumpf , Die Rümpfe Hull [anki:play:a:0]
Termin [anki:play:q:0]	Der Termin , Die Termine Appointment [anki:play:a:0]
Einladung [anki:play:q:0]	Die Einladung , Die Einladungen Invitation [anki:play:a:0]
Lappen [anki:play:q:0]	Die Lappen , Die Lumpen Rag [anki:play:a:0]
Gute [anki:play:q:0]	Das Gute , Die Güter Good [anki:play:a:0]
Behandlung [anki:play:q:0]	Die Behandlung , Behandlungen Treatment [anki:play:a:0]
Weisheit [anki:play:q:0]	Die Weisheit , Die Weisheiten Wisdom [anki:play:a:0]
Element [anki:play:q:0]	Das Element , Die Elemente Element [anki:play:a:0]
Gigant [anki:play:q:0]	Der Gigant , Die Riesen Giant [anki:play:a:0]
Serviette [anki:play:q:0]	Die Serviette , Die Servietten Napkin [anki:play:a:0]
Wäsche [anki:play:q:0]	Die Wäsche , Die Wäschereien Laundry [anki:play:a:0]
Option [anki:play:q:0]	Die Option , Die Optionen Option [anki:play:a:0]
Opa [anki:play:q:0]	Der Opa , Die Großväter Grandpa [anki:play:a:0]
Ranch [anki:play:q:0]	Die Ranch , Die Ranches Ranch [anki:play:a:0]
Skript [anki:play:q:0]	Das Skript , Die Skripte Script [anki:play:a:0]
Einkaufshalle [anki:play:q:0]	Die Einkaufshalle , Die Einkaufszentren Mall [anki:play:a:0]
Ford [anki:play:q:0]	Der Ford , Die Furten Ford [anki:play:a:0]
Witwe [anki:play:q:0]	Die Witwe , Die Witwen Widow [anki:play:a:0]
Krähe [anki:play:q:0]	Die Krähe , Die Krähen Crow [anki:play:a:0]
Faden [anki:play:q:0]	Der Faden , Die Fäden Thread [anki:play:a:0]
Selbstmord [anki:play:q:0]	Die Selbstmord , Die Selbstmorde Suicide [anki:play:a:0]
Sonnenuntergang [anki:play:q:0]	Der Sonnenuntergang , Die Sonne Geht Unter Sunset [anki:play:a:0]
Gallerie [anki:play:q:0]	Die Gallerie , Die Galerien Gallery [anki:play:a:0]
Donner [anki:play:q:0]	Der Donner , Der Donner Thunder [anki:play:a:0]
Seife [anki:play:q:0]	Die Seife , Seifen Soap [anki:play:a:0]
Whisky [anki:play:q:0]	Der Whisky , Die Whiskys Whiskey [anki:play:a:0]
Weibchen [anki:play:q:0]	Das Weibchen , Die Weibchen Female [anki:play:a:0]
Bürgermeister [anki:play:q:0]	Der Bürgermeister , Die Bürgermeister Mayor [anki:play:a:0]
Hub [anki:play:q:0]	Der Hub , Die Striche Stroke [anki:play:a:0]
Klick [anki:play:q:0]	Der Klick , Die Klicks Click [anki:play:a:0]
Ruf [anki:play:q:0]	Der Ruf , Der Ruf Reputation [anki:play:a:0]
Rat [anki:play:q:0]	Der Rat , Die Räte Council [anki:play:a:0]
Stundenplan [anki:play:q:0]	Der Stundenplan , Der Spielplan Schedule [anki:play:a:0]
Friedhof [anki:play:q:0]	Der Friedhof , Die Friedhöfe Cemetery [anki:play:a:0]
Instinkt [anki:play:q:0]	Der Instinkt , Die Instinkte Instinct [anki:play:a:0]
Ruhe [anki:play:q:0]	Die Ruhe , Die Beruhigt Calm [anki:play:a:0]
Arbeitnehmer [anki:play:q:0]	Der Arbeitnehmer , Die Angestellten Employee [anki:play:a:0]
Nest [anki:play:q:0]	Das Nest , Die Nester Nest [anki:play:a:0]
Limit [anki:play:q:0]	Das Limit , Die Grenzwerte Limit [anki:play:a:0]
Deutsche [anki:play:q:0]	Der Deutsche , Die Deutschen German (person) [anki:play:a:0]
Mönch [anki:play:q:0]	Der Mönch , Die Mönche Monk [anki:play:a:0]
Wurm [anki:play:q:0]	Der Wurm , Die Würmer Worm [anki:play:a:0]
Dokument [anki:play:q:0]	Das Dokument , Die Dokumente Document [anki:play:a:0]
Traurigkeit [anki:play:q:0]	Die Traurigkeit , Die Traurigkeiten Sadness [anki:play:a:0]
Lebensdauer [anki:play:q:0]	Die Lebensdauer , Die Lebensdauern Lifetime [anki:play:a:0]
Tänzerin [anki:play:q:0]	Die Tänzerin , Die Tänzer Dancer [anki:play:a:0]
Versicherung [anki:play:q:0]	Die Versicherung , Die Versicherungen Insurance [anki:play:a:0]
Matratze [anki:play:q:0]	Die Matratze , Die Matratzen Mattress [anki:play:a:0]
Mann [anki:play:q:0]	Der Mann , Die Männchen Male [anki:play:a:0]
Klinik [anki:play:q:0]	Die Klinik , Die Kliniken Clinic [anki:play:a:0]
Ad [anki:play:q:0]	Die Ad , Die Anzeigen Ad [anki:play:a:0]
Becher [anki:play:q:0]	Der Becher , Die Becher Mug [anki:play:a:0]
Kit [anki:play:q:0]	Das Kit , Die Kits Kit [anki:play:a:0]
Kommunikation [anki:play:q:0]	Die Kommunikation , Die Kommunikations Communication [anki:play:a:0]
Unglück [anki:play:q:0]	Das Unglück , Die Katastrophen Disaster [anki:play:a:0]
Fliese [anki:play:q:0]	Die Fliese , Die Fliesen Tile [anki:play:a:0]
Empfänger [anki:play:q:0]	Der Empfänger , Die Empfänger Receiver [anki:play:a:0]
Gebrüll [anki:play:q:0]	Das Gebrüll , Die Brüllt Roar [anki:play:a:0]
Truppe [anki:play:q:0]	Die Truppe , Die Truppen Troop [anki:play:a:0]
Sarg [anki:play:q:0]	Der Sarg , Die Särge Coffin [anki:play:a:0]
Freundschaft [anki:play:q:0]	Die Freundschaft , Die Freundschaften Friendship [anki:play:a:0]
Ermittlung [anki:play:q:0]	Die Ermittlung , Die Untersuchungen Investigation [anki:play:a:0]
Verkauf [anki:play:q:0]	Der Verkauf , Die Verkäufe Sale [anki:play:a:0]
Krankenwagen [anki:play:q:0]	Der Krankenwagen , Die Krankenwagen Ambulance [anki:play:a:0]
Mondlicht [anki:play:q:0]	Das Mondlicht , Die Mondlicht Moonlight [anki:play:a:0]
Ward [anki:play:q:0]	The Ward , Die Schutzzauber Ward [anki:play:a:0]
Hosen [anki:play:q:0]	Die Hosen , Die Trouserses Trousers [anki:play:a:0]
Wolle [anki:play:q:0]	Die Wolle , Die Wolle Wool [anki:play:a:0]
Mac [anki:play:q:0]	Die Mac , Die Macs Mac [anki:play:a:0]
Minister [anki:play:q:0]	Der Minister , Die Minister Minister [anki:play:a:0]
Eintritt [anki:play:q:0]	Der Eintritt , Die Einträge Entry [anki:play:a:0]
Dieb [anki:play:q:0]	Der Dieb , Die Diebe Thief [anki:play:a:0]
Aktentasche [anki:play:q:0]	Die Aktentasche , Die Aktentaschen Briefcase [anki:play:a:0]
Mitleid [anki:play:q:0]	Das Mitleid , Die Bemitleidet Pity [anki:play:a:0]
Marine [anki:play:q:0]	Die Marine , Die Marinen Navy [anki:play:a:0]
Insekt [anki:play:q:0]	Das Insekt , Die Insekten Insect [anki:play:a:0]
Velvet [anki:play:q:0]	The Velvet , Die Samt Velvet [anki:play:a:0]
Biene [anki:play:q:0]	Die Biene , Die Bienen Bee [anki:play:a:0]
Gen [anki:play:q:0]	Das Gen , Die Gene Gene [anki:play:a:0]
Salat [anki:play:q:0]	Der Salat , Die Salate Salad [anki:play:a:0]
Windschutzscheibe [anki:play:q:0]	Die Windschutzscheibe , Die Windschutzscheiben Windshield [anki:play:a:0]
Outfit [anki:play:q:0]	Das Outfit , Die Outfits Outfit [anki:play:a:0]
Shuttle [anki:play:q:0]	Der Shuttle , Die Shuttles Shuttle [anki:play:a:0]
Forderung [anki:play:q:0]	Die Forderung , Die Forderungen exigência [anki:play:a:0]
Zufriedenheit [anki:play:q:0]	Die Zufriedenheit , Die Zufriedenheiten Satisfaction [anki:play:a:0]
Produkt [anki:play:q:0]	Das Produkt , Die Produkte Product [anki:play:a:0]
Unkraut [anki:play:q:0]	Das Unkraut , Das Unkraut Weed [anki:play:a:0]
Fitnesscenter [anki:play:q:0]	Das Fitnesscenter , Die FitnessStudios Gym [anki:play:a:0]
Kapital [anki:play:q:0]	Das Kapital , Die Hauptstädte Capital [anki:play:a:0]
Rand [anki:play:q:0]	Der Rand , Die Felgen Rim [anki:play:a:0]
Pfote [anki:play:q:0]	Die Pfote , Die Pfoten Paw [anki:play:a:0]
Kosten [anki:play:q:0]	Die Kosten , Die Kosten Cost [anki:play:a:0]
Plakat [anki:play:q:0]	Das Plakat , Die Poster Poster [anki:play:a:0]
Vampir [anki:play:q:0]	Der Vampir , Die Vampire Vampire [anki:play:a:0]
Identität [anki:play:q:0]	Die Identität , Die Identitäten Identity [anki:play:a:0]
Arschloch [anki:play:q:0]	Das Arschloch , Die Arschlöcher Asshole [anki:play:a:0]
Gurt [anki:play:q:0]	Der Gurt , Die Gurte Strap [anki:play:a:0]
Beispiel [anki:play:q:0]	Das Beispiel , Beispiele Example [anki:play:a:0]
Netz [anki:play:q:0]	Das Netz , Die Stege Web [anki:play:a:0]
Golf [anki:play:q:0]	Der Golf , Die Golfplätze Golf [anki:play:a:0]
Mist [anki:play:q:0]	Den Mist , Scheißt Crap [anki:play:a:0]
Steuer [anki:play:q:0]	Die Steuer , Die Taxs Tax [anki:play:a:0]
Falte [anki:play:q:0]	Die Falte , Die Falten Fold [anki:play:a:0]
Kostüm [anki:play:q:0]	Das Kostüm , Die Kostüme Costume [anki:play:a:0]
Maß [anki:play:q:0]	Das Maß , Maßnahmen Measure [anki:play:a:0]
Gitarre [anki:play:q:0]	Die Gitarre , Die Gitarren Guitar [anki:play:a:0]
Ritter [anki:play:q:0]	Der Ritter , Die Ritter Knight [anki:play:a:0]
Rang [anki:play:q:0]	Der Rang , Die Reihen Rank [anki:play:a:0]
Brunnen [anki:play:q:0]	Der Brunnen , Die Brunnen Fountain [anki:play:a:0]
Stall [anki:play:q:0]	Der Stall , Die Stände Stall [anki:play:a:0]
Funke [anki:play:q:0]	Der Funke , Die Funken Spark [anki:play:a:0]
Müll [anki:play:q:0]	Der Müll Waste [anki:play:a:0]
Champagner [anki:play:q:0]	Der Champagner , Die Champagner Champagne [anki:play:a:0]
Schutz [anki:play:q:0]	Der Schutz , Die Schutz Protection [anki:play:a:0]
Urteil [anki:play:q:0]	Das Urteil , Die Urteile Judgment [anki:play:a:0]
Sympathie [anki:play:q:0]	Die Sympathie , Die Sympathien Sympathy [anki:play:a:0]
Violett [anki:play:q:0]	Das Violett , Die Veilchen Violet [anki:play:a:0]
Aufprall [anki:play:q:0]	Der Aufprall , Die Auswirkungen Impact [anki:play:a:0]
Enttäuschung [anki:play:q:0]	Die Enttäuschung , Die Enttäuschungen Disappointment [anki:play:a:0]
Trink [anki:play:q:0]	Das Trink , Die Drinkings Drinking [anki:play:a:0]
Bewusstsein [anki:play:q:0]	Das Bewusstsein , Die Bewussts Consciousness [anki:play:a:0]
Taschentuch [anki:play:q:0]	Das Taschentuch , Die Taschentücher Handkerchief [anki:play:a:0]
Tanzen [anki:play:q:0]	Das Tanzen , Die Dancings Dancing [anki:play:a:0]
Parfüm [anki:play:q:0]	Das Parfüm , Die Düfte Perfume [anki:play:a:0]
Netzwerk [anki:play:q:0]	Das Netzwerk , Die Netzwerke Network [anki:play:a:0]
Anspruch [anki:play:q:0]	Der Anspruch , Die Ansprüche Claim [anki:play:a:0]
Nonne [anki:play:q:0]	Die Nonne , Die Nonnen Nun [anki:play:a:0]
Krone [anki:play:q:0]	Die Krone , Die Kronen Crown [anki:play:a:0]
Geländer [anki:play:q:0]	Das Geländer , Die Geländer Railing [anki:play:a:0]
Lizenz [anki:play:q:0]	Die Lizenz , Die Lizenzen License [anki:play:a:0]
Barmherzigkeit [anki:play:q:0]	Die Barmherzigkeit , Die Barmherzigkeit Mercy [anki:play:a:0]
Ballon [anki:play:q:0]	Der Ballon , Die Ballons Balloon [anki:play:a:0]
Chaos [anki:play:q:0]	Das Chaos , Die Chaoses Chaos [anki:play:a:0]
Fieber [anki:play:q:0]	Das Fieber , Die Fieber Fever [anki:play:a:0]
Schließfach [anki:play:q:0]	Das Schließfach , Die Schließfächer Locker [anki:play:a:0]
Sitzung [anki:play:q:0]	Die Sitzung , Die Sitzungen Session [anki:play:a:0]
Burst [anki:play:q:0]	Die Burst , Die Bursts Burst [anki:play:a:0]
Spitzer [anki:play:q:0]	Der Spitzer , Die Peaks Peak [anki:play:a:0]
Trommel [anki:play:q:0]	Die Trommel , Die Trommeln Drum [anki:play:a:0]
Frosch [anki:play:q:0]	Der Frosch , Die Frösche Frog [anki:play:a:0]
Bemerkung [anki:play:q:0]	Die Bemerkung , Die Bemerkungen Remark [anki:play:a:0]
Verdacht [anki:play:q:0]	Der Verdacht , Der Verdacht Suspicion [anki:play:a:0]
Jeep [anki:play:q:0]	Der Jeep , Die Jeeps Jeep [anki:play:a:0]
Literatur [anki:play:q:0]	Die Literatur , Die Literaturen Literature [anki:play:a:0]
Bogenschütze [anki:play:q:0]	Der Bogenschütze , Die Bogenschützen Archer [anki:play:a:0]
Haushalt [anki:play:q:0]	Der Haushalt , Die Haushalte Household [anki:play:a:0]
Pulver [anki:play:q:0]	Das Pulver , Die Pulver Powder [anki:play:a:0]
Hirte [anki:play:q:0]	Der Hirte , Die Hirten Shepherd [anki:play:a:0]
Linse [anki:play:q:0]	Die Linse , Die Linsen Lens [anki:play:a:0]
Favorit [anki:play:q:0]	Der Favorit , Die Favoriten Favorite [anki:play:a:0]
Madame [anki:play:q:0]	Die Madame , Die Madames Madame [anki:play:a:0]
Villa [anki:play:q:0]	Die Villa , Die Herrenhäuser Mansion [anki:play:a:0]
Boom [anki:play:q:0]	Der Boom , Die Ausleger Boom [anki:play:a:0]
Überprüfung [anki:play:q:0]	Die Überprüfung , Die Überprüfungen Review, coreção [anki:play:a:0]
Rezeption [anki:play:q:0]	Die Rezeption , Die Empfänge Reception [anki:play:a:0]
Schrott [anki:play:q:0]	Der Schrott , Die Fetzen Scrap [anki:play:a:0]
Wulst [anki:play:q:0]	Der Wulst , Die Perlen Bead [anki:play:a:0]
Blendung [anki:play:q:0]	Die Blendung , Die Blicke Glare [anki:play:a:0]
Strömung [anki:play:q:0]	Die Strömung , Die Ströme Flow [anki:play:a:0]
Cafe [anki:play:q:0]	Das Cafe , Die Cafés Cafe [anki:play:a:0]
Status [anki:play:q:0]	Der Status , Die Zustände Status [anki:play:a:0]
Pochen [anki:play:q:0]	Das Pochen , Die Poundings Pounding [anki:play:a:0]
Rakete [anki:play:q:0]	Die Rakete , Die Raketen Rocket [anki:play:a:0]
Schlucht [anki:play:q:0]	Die Schlucht , Die Schluchten Canyon [anki:play:a:0]
Spinne [anki:play:q:0]	Die Spinne , Die Spinnen Spider [anki:play:a:0]
Persönlichkeit [anki:play:q:0]	Die Persönlichkeit , Die Persönlichkeiten Personality [anki:play:a:0]
Campus [anki:play:q:0]	Der Campus , Die Campus Campus [anki:play:a:0]
Fluch [anki:play:q:0]	Der Fluch , Die Flüche Curse [anki:play:a:0]
Treppenhaus [anki:play:q:0]	Das Treppenhaus , Die Treppenhäuser Staircase [anki:play:a:0]
Drang [anki:play:q:0]	Der Drang , Die Triebe Urge [anki:play:a:0]
Frustration [anki:play:q:0]	Die Frustration , Die Frustrationen Frustration [anki:play:a:0]
Pumpe [anki:play:q:0]	Die Pumpe , Die Pumpen Pump [anki:play:a:0]
Leichtigkeit [anki:play:q:0]	Die Leichtigkeit , Die Kungen Ease [anki:play:a:0]
Zählung [anki:play:q:0]	Die Zählung , Die Grafen Count [anki:play:a:0]
Lösung [anki:play:q:0]	Die Lösung , Die Lösungen Solution [anki:play:a:0]
Schmuck [anki:play:q:0]	Der Schmuck , Die Schmuck Jewelry [anki:play:a:0]
Sirene [anki:play:q:0]	Die Sirene , Die Sirenen Siren [anki:play:a:0]
Tradition [anki:play:q:0]	Die Tradition , Die Traditionen Tradition [anki:play:a:0]
Leer [anki:play:q:0]	Das Leer , Die Bordsteine Curb [anki:play:a:0]
Pirat [anki:play:q:0]	Der Pirat , Die Piraten Pirate [anki:play:a:0]
Beschreibung [anki:play:q:0]	Die Beschreibung , Beschreibungen Description [anki:play:a:0]
Tonhöhe [anki:play:q:0]	Die Tonhöhe , Die Stellplätze Pitch [anki:play:a:0]
Pizza [anki:play:q:0]	Die Pizza , Die Pizzas Pizza [anki:play:a:0]
Elefant [anki:play:q:0]	Der Elefant , Die Elefanten Elephant [anki:play:a:0]
Politik [anki:play:q:0]	Die Politik , Die Politicses Politics [anki:play:a:0]
Tennis [anki:play:q:0]	Der Tennis , Die Tennises Tennis [anki:play:a:0]
Hunger [anki:play:q:0]	Der Hunger , Die Hungert Hunger [anki:play:a:0]
Genie [anki:play:q:0]	Das Genie , Die Genies Genius [anki:play:a:0]
Ziege [anki:play:q:0]	Die Ziege , Die Ziegen Goat [anki:play:a:0]
Sieg [anki:play:q:0]	Der Sieg , Die Siege Victory [anki:play:a:0]
Kombination [anki:play:q:0]	Die Kombination , Kombinationen Combination [anki:play:a:0]
Zugehörigkeit [anki:play:q:0]	Die Zugehörigkeit , Die Zugehörigkeiten Affiliation [anki:play:a:0]
Momma [anki:play:q:0]	Das Momma , Die Mommas Momma [anki:play:a:0]
Umhang [anki:play:q:0]	Der Umhang , Die Umhänge Cape [anki:play:a:0]
Scheinwerfer [anki:play:q:0]	Der Scheinwerfer , Die Scheinwerfer Headlight [anki:play:a:0]
Gouverneur [anki:play:q:0]	Der Gouverneur , Die Gouverneure Governor [anki:play:a:0]
Sauerstoff [anki:play:q:0]	Die Sauerstoff , Sauerstoffe Oxygen [anki:play:a:0]
Bischof [anki:play:q:0]	Der Bischof , Die Bischöfe Bishop [anki:play:a:0]
Entwicklung [anki:play:q:0]	Die Entwicklung , Die Entwicklungen Development [anki:play:a:0]
Fingernagel [anki:play:q:0]	Der Fingernagel , Die Fingernägel Fingernail [anki:play:a:0]
Punktzahl [anki:play:q:0]	Die Punktzahl , Die Noten Score [anki:play:a:0]
Steuermann [anki:play:q:0]	Der Steuermann , Die Mates Mate [anki:play:a:0]
Fahrer [anki:play:q:0]	Der Fahrer , Die Fahrer Rider [anki:play:a:0]
Weinstock [anki:play:q:0]	Der Weinstock , Die Reben Vine [anki:play:a:0]
Suite [anki:play:q:0]	Die Suite , Die Suiten Suite [anki:play:a:0]
Barkeeper [anki:play:q:0]	Der Barkeeper , Die Barkeeper Bartender [anki:play:a:0]
Koks [anki:play:q:0]	Der Koks , Die Kokse Coke [anki:play:a:0]
Melodie [anki:play:q:0]	Die Melodie , Die Melodien Tune [anki:play:a:0]
Herrlichkeit [anki:play:q:0]	Die Herrlichkeit , Die Herrlichkeiten Glory [anki:play:a:0]
Rabbi [anki:play:q:0]	Der Rabbi , Die Rabbiner Rabbi [anki:play:a:0]
Vieh [anki:play:q:0]	Das Vieh , Die Rinder Cattle [anki:play:a:0]
Ritual [anki:play:q:0]	Das Ritual , Die Rituale Ritual [anki:play:a:0]
Begrüßung [anki:play:q:0]	Die Begrüßung , Die Grüße Greeting [anki:play:a:0]
Scheibe [anki:play:q:0]	Die Scheibe , Die Scheiben Slice [anki:play:a:0]
Homer [anki:play:q:0]	Die Homer , Die Home Runs Homer [anki:play:a:0]
Kamin [anki:play:q:0]	Der Kamin , Die Kamine Fireplace [anki:play:a:0]
Trikot [anki:play:q:0]	Das Trikot , Die Trikots Jersey [anki:play:a:0]
Medien [anki:play:q:0]	Die Medien , Die Medien Media [anki:play:a:0]
Pop [anki:play:q:0]	Die Pop , The Pops Pop [anki:play:a:0]
Fracht [anki:play:q:0]	Die Fracht , Die Ladungen Cargo [anki:play:a:0]
Stellvertretende [anki:play:q:0]	Der Stellvertretende , Die Abgeordneten Deputy [anki:play:a:0]
Verzweiflung [anki:play:q:0]	Die Verzweiflung , Die Verzweiflungen Despair [anki:play:a:0]
Territorium [anki:play:q:0]	Das Territorium , Die Gebiete Territory [anki:play:a:0]
Jazz [anki:play:q:0]	Die Jazz , Die Jazzs Jazz [anki:play:a:0]
Umarmung [anki:play:q:0]	Die Umarmung , Die Umarmungen Hug [anki:play:a:0]
Pfeife [anki:play:q:0]	Die Pfeife , Die Pfeifen Whistle [anki:play:a:0]
Handwerk [anki:play:q:0]	Das Handwerk , Das Handwerk Craft [anki:play:a:0]
Tageslicht [anki:play:q:0]	Das Tageslicht , Die Daylighies Daylight [anki:play:a:0]
Slip [anki:play:q:0]	Der Slip , Die Schieber Slip [anki:play:a:0]
Rüstung [anki:play:q:0]	Die Rüstung , Die Rüstungen Armor [anki:play:a:0]
Rucksack [anki:play:q:0]	Der Rucksack , Die Rucksäcke Backpack [anki:play:a:0]
Vorschlag [anki:play:q:0]	Der Vorschlag , Die Vorschläge Suggestion [anki:play:a:0]
Symbol [anki:play:q:0]	Das Symbol , Die Symbole Symbol [anki:play:a:0]
Kolonie [anki:play:q:0]	Die Kolonie , Die Kolonien Colony [anki:play:a:0]
Fazit [anki:play:q:0]	Das Fazit , Die Schlussfolgerungen Conclusion [anki:play:a:0]
Nasenloch [anki:play:q:0]	Das Nasenloch , Die Nasenlöcher Nostril [anki:play:a:0]
Speer [anki:play:q:0]	Der Speer , Die Speere Spear [anki:play:a:0]
Tomate [anki:play:q:0]	Die Tomate , Die Tomaten Tomato [anki:play:a:0]
Kalb [anki:play:q:0]	Das Kalb , Die Kälber Calf [anki:play:a:0]
Fund [anki:play:q:0]	Der Fund , Die Entdeckungen Discovery [anki:play:a:0]
Zimmer [anki:play:q:0]	das Zimmer , Die Zimmer Sala, room [anki:play:a:0]
Lieferung [anki:play:q:0]	Die Lieferung , Die Einteilungen Delivery [anki:play:a:0]
Spray [anki:play:q:0]	Das Spray , Die Spraies Spray [anki:play:a:0]
Flüssigkeit [anki:play:q:0]	Die Flüssigkeit , Die Flüssigkeiten Liquid [anki:play:a:0]
Kraftstoff [anki:play:q:0]	Die Kraftstoff , Die Kraftstoffe Fuel [anki:play:a:0]
Unterwäsche [anki:play:q:0]	Die Unterwäsche , Die Unterwäsche Underwear [anki:play:a:0]
Kuppel [anki:play:q:0]	Die Kuppel , Die Kuppeln Dome [anki:play:a:0]
Bevölkerung [anki:play:q:0]	Die Bevölkerung , Die Populationen Population [anki:play:a:0]
Neigung [anki:play:q:0]	Die Neigung , Die Neigungen Affection [anki:play:a:0]
Religion [anki:play:q:0]	Die Religion , Die Religionen Religion [anki:play:a:0]
Sänger [anki:play:q:0]	Der Sänger , Die Sänger Singer [anki:play:a:0]
Illusion [anki:play:q:0]	Die Illusion , Die Illusionen Illusion [anki:play:a:0]
Link [anki:play:q:0]	Der Link , Links Link [anki:play:a:0]
Innenraum [anki:play:q:0]	Der Innenraum , Die Innenräume Interior [anki:play:a:0]
Zone [anki:play:q:0]	Die Zone , Die Zonen Zone [anki:play:a:0]
Standard [anki:play:q:0]	Der Standard , Die Standards Standard [anki:play:a:0]
Kohlen [anki:play:q:0]	Die Kohlen , Die Kohlen Coal [anki:play:a:0]
Klumpen [anki:play:q:0]	Der Klumpen , Die Klumpen Lump [anki:play:a:0]
Charm [anki:play:q:0]	Der Charm , Der Charme Charm [anki:play:a:0]
Legende [anki:play:q:0]	Die Legende , Die Legenden Legend [anki:play:a:0]
Konsequenz [anki:play:q:0]	Die Konsequenz , Die Konsequenzen Consequence [anki:play:a:0]
Beobachtung [anki:play:q:0]	Die Beobachtung , Die Beobachtungen Observation [anki:play:a:0]
Zahlung [anki:play:q:0]	Die Zahlung , Das Zahlt Pay [anki:play:a:0]
Prospekt [anki:play:q:0]	Das Prospekt , Die Aussichten Prospect [anki:play:a:0]
UBahn [anki:play:q:0]	Die UBahn , Die UBahnen Subway [anki:play:a:0]
Kirsche [anki:play:q:0]	Die Kirsche , Die Kirschen Cherry [anki:play:a:0]
Händler [anki:play:q:0]	Der Händler , Die Händler Dealer [anki:play:a:0]
Zuordnung [anki:play:q:0]	Die Zuordnung , Die Zuordnungen Assignment [anki:play:a:0]
Eile [anki:play:q:0]	Die Eile , Die Eilt Hurry [anki:play:a:0]
Geliebte [anki:play:q:0]	Die Geliebte , Die Mätressen Mistress [anki:play:a:0]
Unsinn [anki:play:q:0]	Der Unsinn , Die Unsinn Nonsense [anki:play:a:0]
Komitee [anki:play:q:0]	Das Komitee , Die Ausschüsse Committee [anki:play:a:0]
Echo [anki:play:q:0]	Das Echo , Die Echos Echo [anki:play:a:0]
Durchhang [anki:play:q:0]	Der Durchhang , Die Hose Slack [anki:play:a:0]
Warenhaus [anki:play:q:0]	Das Warenhaus , Die Lagerhäuser Warehouse [anki:play:a:0]
Toast [anki:play:q:0]	Der Toast , Die Toasts Toast [anki:play:a:0]
Einrichtung [anki:play:q:0]	Die Einrichtung , Die Einrichtungen Facility [anki:play:a:0]
Basketball [anki:play:q:0]	Der Basketball , Die Basketbälle Basketball [anki:play:a:0]
Schnurrbart [anki:play:q:0]	Der Schnurrbart , Die Schnurrbärte Mustache [anki:play:a:0]
Senator [anki:play:q:0]	Der Senator , Die Senatoren Senator [anki:play:a:0]
Teilen [anki:play:q:0]	Das Teilen , Die Aktien Share [anki:play:a:0]
Augenlid [anki:play:q:0]	Das Augenlid , Die Augenlider Eyelid [anki:play:a:0]
Begeisterung [anki:play:q:0]	Die Begeisterung , Die Begeisterung Enthusiasm [anki:play:a:0]
Chunk [anki:play:q:0]	Die Chunk , Die Brocken Chunk [anki:play:a:0]
Schildkröte [anki:play:q:0]	Die Schildkröte , Die Schildkröten Turtle [anki:play:a:0]
Alkohol [anki:play:q:0]	Der Alkohol , Die Alkohole Alcohol [anki:play:a:0]
Gummi [anki:play:q:0]	Die Gummi , Die Gummis Gum [anki:play:a:0]
Truthahn [anki:play:q:0]	Der Truthahn , Die Truthähne Turkey [anki:play:a:0]
Prediger [anki:play:q:0]	Der Prediger , Die Prediger Preacher [anki:play:a:0]
Besitz [anki:play:q:0]	Der Besitz , Die Besitzungen Possession [anki:play:a:0]
Dolly [anki:play:q:0]	Der Dolly , Die Dollies Dolly [anki:play:a:0]
Leinen [anki:play:q:0]	Das Leinen , Die Bettwäsche Linen [anki:play:a:0]
Vortrag [anki:play:q:0]	Der Vortrag , Die Vorträge Lecture [anki:play:a:0]
Heap [anki:play:q:0]	Der Heap , Die Haufen Heap [anki:play:a:0]
Fotograf [anki:play:q:0]	Der Fotograf , Die Fotografen Photographer [anki:play:a:0]
Bremse [anki:play:q:0]	Die Bremse , Die Bremsen Brake [anki:play:a:0]
Schürze [anki:play:q:0]	Die Schürze , Die Schürzen Apron [anki:play:a:0]
Jury [anki:play:q:0]	Die Jury , Jurys Jury [anki:play:a:0]
Anhörung [anki:play:q:0]	Die Anhörung , Die Anhörungen Hearing [anki:play:a:0]
Graue [anki:play:q:0]	Das Graue , Die Grautöne Gray [anki:play:a:0]
Methode [anki:play:q:0]	Die Methode , Methoden Method [anki:play:a:0]
Referenz [anki:play:q:0]	Die Referenz , Die Verweise Reference [anki:play:a:0]
Ekel [anki:play:q:0]	Der Ekel , Die Ekelt Disgust [anki:play:a:0]
Flotte [anki:play:q:0]	Die Flotte , Die Flotten Liquor [anki:play:a:0]
Lippenstift [anki:play:q:0]	Der Lippenstift , Lippenstifte Lipstick [anki:play:a:0]
Kern [anki:play:q:0]	Der Kern , Die Kerne Core [anki:play:a:0]
Einzelne [anki:play:q:0]	Der Einzelne , Die Personen Individual [anki:play:a:0]
Container [anki:play:q:0]	Der Container , Die Behälter Container [anki:play:a:0]
Hure [anki:play:q:0]	Die Hure , Die Huren Whore [anki:play:a:0]
Kleinkind [anki:play:q:0]	Das Kleinkind , Die Säuglinge Infant [anki:play:a:0]
Sonnenbrille [anki:play:q:0]	Die Sonnenbrille , Die Sunglasseses Sunglasses [anki:play:a:0]
Schlauch [anki:play:q:0]	Der Schlauch , Die Schläuche Hose [anki:play:a:0]
Konzert [anki:play:q:0]	Das Konzert , Konzerte Concert [anki:play:a:0]
Bullshit [anki:play:q:0]	Das Bullshit , Die Bullshits Bullshit [anki:play:a:0]
Eisenbahn [anki:play:q:0]	Die Eisenbahn , Die Eisenbahnen Railroad [anki:play:a:0]
Parade [anki:play:q:0]	Die Parade , Die Paraden Parade [anki:play:a:0]
Fach [anki:play:q:0]	Das Fach , Die Abteile Compartment [anki:play:a:0]
Bewohner [anki:play:q:0]	Der Bewohner , Die Bewohner Resident [anki:play:a:0]
Backofen [anki:play:q:0]	Der Backofen , Die Öfen Oven [anki:play:a:0]
Techniker [anki:play:q:0]	Der Techniker , Die Techniker Technician [anki:play:a:0]
Verfahren [anki:play:q:0]	Das Verfahren , Die Verfahren Procedure [anki:play:a:0]
Kämpfer [anki:play:q:0]	Der Kämpfer , Die Kämpfer Fighter [anki:play:a:0]
Korn [anki:play:q:0]	Das Korn , Die Körner Grain [anki:play:a:0]
Picknick [anki:play:q:0]	Das Picknick , Die Picknicks Picnic [anki:play:a:0]
Stamm [anki:play:q:0]	Der Stamm , Die Stämme Tribe [anki:play:a:0]
Knospe [anki:play:q:0]	Die Knospe , Die Knospen Bud [anki:play:a:0]
Wiese [anki:play:q:0]	Die Wiese , Die Wiesen Meadow [anki:play:a:0]
Öffentlichkeit [anki:play:q:0]	Die Öffentlichkeit , Die Öffentlichkeit Public [anki:play:a:0]
Gift [anki:play:q:0]	Das Gift , Die Gifte Poison [anki:play:a:0]
Büffel [anki:play:q:0]	Der Büffel , Die Büffel Buffalo [anki:play:a:0]
Region [anki:play:q:0]	Die Region , Die Regionen Region [anki:play:a:0]
Produktion [anki:play:q:0]	Die Produktion , Die Produktionen Production [anki:play:a:0]
Soda [anki:play:q:0]	Die Soda , Die Limonaden Soda [anki:play:a:0]
Eule [anki:play:q:0]	Die Eule , Die Eulen Owl [anki:play:a:0]
Menü [anki:play:q:0]	Das Menü , Die Menüs Menu [anki:play:a:0]
Kick [anki:play:q:0]	Der Kick , Die Tritte Kick [anki:play:a:0]
Ruine [anki:play:q:0]	Die Ruine , Die Ruinen Ruin [anki:play:a:0]
Rampe [anki:play:q:0]	Die Rampe , Die Rampen Ramp [anki:play:a:0]
Achsschenkel [anki:play:q:0]	Der Achsschenkel , Die Knöchel Knuckle [anki:play:a:0]
Gans [anki:play:q:0]	Die Gans , Die Gänse Goose [anki:play:a:0]
Fee [anki:play:q:0]	Die Fee , Die Feen Fairy [anki:play:a:0]
Mannschaft [anki:play:q:0]	Die Mannschaft , Die Kader Squad [anki:play:a:0]
Offizielle [anki:play:q:0]	Das Offizielle , Die Beamten Official [anki:play:a:0]
Marke [anki:play:q:0]	Die Marke , Die Marken Brand [anki:play:a:0]
Orgel [anki:play:q:0]	Die Orgel , Die Organe Organ [anki:play:a:0]
Schmetterling [anki:play:q:0]	Der Schmetterling , Die Schmetterlinge Butterfly [anki:play:a:0]
Reich [anki:play:q:0]	Das Reich , Die Reiche Empire [anki:play:a:0]
Profil [anki:play:q:0]	Das Profil , Die Profile Profile [anki:play:a:0]
Unglaube [anki:play:q:0]	Der Unglaube , Die Unglauben Disbelief [anki:play:a:0]
Hain [anki:play:q:0]	Der Hain , Die Haine Grove [anki:play:a:0]
Sattel [anki:play:q:0]	Der Sattel , Die Sättel Saddle [anki:play:a:0]
Cluster [anki:play:q:0]	Die Cluster , Die Cluster Cluster [anki:play:a:0]
Satellit [anki:play:q:0]	Der Satellit , Die Satelliten Satellite [anki:play:a:0]
Abzug [anki:play:q:0]	Der Abzug , Die Auslöser Trigger [anki:play:a:0]
Welpe [anki:play:q:0]	Der Welpe , Die Welpen Puppy [anki:play:a:0]
Warte [anki:play:q:0]	Die Warte , Die Erwartungen Waiting [anki:play:a:0]
Glühbirne [anki:play:q:0]	Die Glühbirne , Die Zwiebeln Bulb [anki:play:a:0]
Kommode [anki:play:q:0]	Die Kommode , Die Kommoden Dresser [anki:play:a:0]
Patrouille [anki:play:q:0]	Die Patrouille , Die Patrouillen Patrol [anki:play:a:0]
Adler [anki:play:q:0]	Der Adler , Die Adler Eagle [anki:play:a:0]
Privatsphäre [anki:play:q:0]	Der Privatsphäre , Die Privatsphären Privacy [anki:play:a:0]
Fluid [anki:play:q:0]	Das Fluid , Fluide Fluid [anki:play:a:0]
Herde [anki:play:q:0]	Die Herde , Die Herden Herd [anki:play:a:0]
Kopfschmerz [anki:play:q:0]	Der Kopfschmerz , Die Kopfschmerzen Headache [anki:play:a:0]
Vergnügungspark [anki:play:q:0]	Der Vergnügungspark , Vergnügungen Amusement [anki:play:a:0]
Rollstuhl [anki:play:q:0]	Der Rollstuhl , Die Rollstühle Wheelchair [anki:play:a:0]
Richtlinie [anki:play:q:0]	Die Richtlinie , Die Politik Policy [anki:play:a:0]
Belle [anki:play:q:0]	Das Belle , Die Belles Belle [anki:play:a:0]
Tabak [anki:play:q:0]	Die Tabak , Die Tabake Tobacco [anki:play:a:0]
Einstellung [anki:play:q:0]	Die Einstellung , Einstellungen Setting [anki:play:a:0]
Tätowierung [anki:play:q:0]	Die Tätowierung , Die Tattoos Tattoo [anki:play:a:0]
Last [anki:play:q:0]	Die Last , Die Lasten Burden [anki:play:a:0]
Rutsche [anki:play:q:0]	Die Rutsche , Die Schieber Slide [anki:play:a:0]
Fleck [anki:play:q:0]	Der Fleck , Die Flecken Stain [anki:play:a:0]
Bindung [anki:play:q:0]	Die Bindung , Die Anleihen Bond [anki:play:a:0]
Schwimmen [anki:play:q:0]	Das Schwimmen , Die Swimming Swimming [anki:play:a:0]
Grundlage [anki:play:q:0]	Die Grundlage , Die Grundlagen Foundation [anki:play:a:0]
Verletzung [anki:play:q:0]	Die Verletzung , Die Verletzungen Haben Injury [anki:play:a:0]
Liga [anki:play:q:0]	Die Liga , Die Ligen League [anki:play:a:0]
Batterie [anki:play:q:0]	Die Batterie , Die Batterien Battery [anki:play:a:0]
Regenschirm [anki:play:q:0]	Der Regenschirm , Die Sonnenschirme Umbrella [anki:play:a:0]
Kaiser [anki:play:q:0]	Der Kaiser , Die Kaiser Emperor [anki:play:a:0]
Pier [anki:play:q:0]	Der Pier , Die Pfeiler Pier [anki:play:a:0]
Wasserhahn [anki:play:q:0]	Der Wasserhahn , Die Wasserhähne Tap [anki:play:a:0]
Cutter [anki:play:q:0]	Der Cutter , Die Schneidwerkzeuge Cutter [anki:play:a:0]
Dachboden [anki:play:q:0]	Der Dachboden , Die Dachböden Attic [anki:play:a:0]
Tiger [anki:play:q:0]	Der Tiger , Die Tiger Tiger [anki:play:a:0]
Pal [anki:play:q:0]	Die Pal , Die Kumpels Pal [anki:play:a:0]
Vorfahr [anki:play:q:0]	Der Vorfahr , Die Vorfahren Ancestor [anki:play:a:0]
Konzentration [anki:play:q:0]	Die Konzentration , Die Konzentrationen Concentration [anki:play:a:0]
Segen [anki:play:q:0]	Der Segen , Die Segnungen Blessing [anki:play:a:0]
Leiste [anki:play:q:0]	Die Leiste , Die Leisten Ledge [anki:play:a:0]
Fackel [anki:play:q:0]	Die Fackel , Die Fackeln Torch [anki:play:a:0]
Tinten [anki:play:q:0]	Die Tinten , Die Tinten Ink [anki:play:a:0]
Handlung [anki:play:q:0]	Die Handlung , Die Grundstücke Plot [anki:play:a:0]
Miete [anki:play:q:0]	Die Miete , Die Mieten Rent [anki:play:a:0]
Maultier [anki:play:q:0]	Das Maultier , Die Maultiere Mule [anki:play:a:0]
Umgebung [anki:play:q:0]	Die Umgebung , Die Umgebungen Environment [anki:play:a:0]
Stirnrunzeln [anki:play:q:0]	Das Stirnrunzeln , Die Stirn Runzelt Frown [anki:play:a:0]
Inspektor [anki:play:q:0]	Der Inspektor , Die Inspektoren Inspector [anki:play:a:0]
Mitten [anki:play:q:0]	Die Mitten , Die Midsts Midst [anki:play:a:0]
Verlegenheit [anki:play:q:0]	Die Verlegenheit , Die Peinlichkeiten Embarrassment [anki:play:a:0]
Beschwerde [anki:play:q:0]	Die Beschwerde , Die Beschwerden Complaint [anki:play:a:0]
Spannfutter [anki:play:q:0]	Das Spannfutter , Die Spann Chuck [anki:play:a:0]
Clearing [anki:play:q:0]	Die Clearing , Die Lichtungen Clearing [anki:play:a:0]
Krise [anki:play:q:0]	Die Krise , Die Krisen Crisis [anki:play:a:0]
Halskette [anki:play:q:0]	Die Halskette , Die Halsketten Necklace [anki:play:a:0]
Laterne [anki:play:q:0]	Die Laterne , Die Laternen Lantern [anki:play:a:0]
Reichtum [anki:play:q:0]	Der Reichtum , Die Reichtümer Wealth [anki:play:a:0]
Zivilisation [anki:play:q:0]	Die Zivilisation , Die Zivilisationen Civilization [anki:play:a:0]
Konzept [anki:play:q:0]	Das Konzept , Die Konzepte Concept [anki:play:a:0]
Lamm [anki:play:q:0]	Das Lamm , Die Lämmer Lamb [anki:play:a:0]
Manschette [anki:play:q:0]	Die Manschette , Die Manschetten Cuff [anki:play:a:0]
Jungfrau [anki:play:q:0]	Die Jungfrau , Die Jungfrauen Virgin [anki:play:a:0]
Eichhörnchen [anki:play:q:0]	Das Eichhörnchen , Die Eichhörnchen Squirrel [anki:play:a:0]
Star [anki:play:q:0]	Der Star , Die Stare Starling [anki:play:a:0]
Depression [anki:play:q:0]	Die Depression , Die Vertiefungen Depression [anki:play:a:0]
Speicher [anki:play:q:0]	Das Speicher , Die Speicher Storage [anki:play:a:0]
Altar [anki:play:q:0]	Der Altar , Die Altäre Altar [anki:play:a:0]
Tragödie [anki:play:q:0]	Die Tragödie , Die Tragödien Tragedy [anki:play:a:0]
Reisende [anki:play:q:0]	Der Reisende , Die Reisenden Traveler [anki:play:a:0]
Vertrauen [anki:play:q:0]	Das Vertrauen Trust [anki:play:a:0]
Königreich [anki:play:q:0]	Das Königreich , Die Königreiche Kingdom [anki:play:a:0]
Juwel [anki:play:q:0]	Das Juwel , Die Juwelen Jewel [anki:play:a:0]
Musiker [anki:play:q:0]	Der Musiker , Die Musiker Musician [anki:play:a:0]
Junk [anki:play:q:0]	Die Junk , Die Dschunken Junk [anki:play:a:0]
Sonnenschein [anki:play:q:0]	Der Sonnenschein , Die Sonne Scheint Sunshine [anki:play:a:0]
Knabe [anki:play:q:0]	Der Knabe , Die Jungs Lad [anki:play:a:0]
Elf [anki:play:q:0]	Der Elf , Die Elfen Elf [anki:play:a:0]
Protest [anki:play:q:0]	Der Protest , Die Proteste Protest [anki:play:a:0]
Exekutive [anki:play:q:0]	Die Exekutive , Die Führungskräfte Executive [anki:play:a:0]
Aspekt [anki:play:q:0]	Das Aspekt , Die Aspekte Aspect [anki:play:a:0]
Zifferblatt [anki:play:q:0]	Das Zifferblatt , Die Zifferblätter Dial [anki:play:a:0]
Hausschuh [anki:play:q:0]	Der Hausschuh , Die Pantoffeln Slipper [anki:play:a:0]
Schauspielerin [anki:play:q:0]	Die Schauspielerin , Die Schauspielerinnen Actress [anki:play:a:0]
Shooting [anki:play:q:0]	Das Shooting , Die Dreharbeiten Shooting [anki:play:a:0]
Ohrring [anki:play:q:0]	Der Ohrring , Die Ohrringe Earring [anki:play:a:0]
Ameise [anki:play:q:0]	Die Ameise , Die Ameisen Ant [anki:play:a:0]
Patty [anki:play:q:0]	Die Patty , Die Bratlinge Patty [anki:play:a:0]
Sauce [anki:play:q:0]	Die Sauce , Die Soßen Sauce [anki:play:a:0]
Intensität [anki:play:q:0]	Die Intensität , Die Intensitäten Intensity [anki:play:a:0]
Graben [anki:play:q:0]	Der Graben , Die Gräben Ditch [anki:play:a:0]
Gänseblümchen [anki:play:q:0]	Das Gänseblümchen , Das Gänseblümchen Daisy [anki:play:a:0]
Kapelle [anki:play:q:0]	Die Kapelle , Die Kapellen Chapel [anki:play:a:0]
Sumpf [anki:play:q:0]	Der Sumpf , Die Sümpfe Swamp [anki:play:a:0]
Beziehung [anki:play:q:0]	Die Beziehung , Die Beziehungen Relation [anki:play:a:0]
Vermutung [anki:play:q:0]	Die Vermutung , Die Vermutungen Guess [anki:play:a:0]
Kran [anki:play:q:0]	Der Kran , Die Kräne Crane [anki:play:a:0]
Begegnung [anki:play:q:0]	Die Begegnung , Die Begegnungen Encounter [anki:play:a:0]
Sequenz [anki:play:q:0]	Die Sequenz , Die Sequenzen Sequence [anki:play:a:0]
Fragment [anki:play:q:0]	Das Fragment , Die Fragmente Fragment [anki:play:a:0]
Entwurf [anki:play:q:0]	Der Entwurf , Die Entwürfe Draft [anki:play:a:0]
Diner [anki:play:q:0]	Das Diner , Diners Diner [anki:play:a:0]
Funktion [anki:play:q:0]	Die Funktion , Die Funktionen Function [anki:play:a:0]
Organisation [anki:play:q:0]	Die Organisation , Die Organisationen Organization [anki:play:a:0]
Skelett [anki:play:q:0]	Das Skelett , Die Skelette Skeleton [anki:play:a:0]
Elend [anki:play:q:0]	Das Elend , Das Elend Misery [anki:play:a:0]
Kraut [anki:play:q:0]	Das Kraut , Die Kräuter Herb [anki:play:a:0]
Stumpf [anki:play:q:0]	Der Stumpf , Die Stümpfe Stump [anki:play:a:0]
Einsatz [anki:play:q:0]	Der Einsatz , Die Einsätze Stake [anki:play:a:0]
Puff [anki:play:q:0]	Die Puff , Die Windbeutel Puff [anki:play:a:0]
Kreation [anki:play:q:0]	Die Kreation , Die Kreationen Creation [anki:play:a:0]
Gefolge [anki:play:q:0]	Das Gefolge , Die Totenwache Wake [anki:play:a:0]
Matte [anki:play:q:0]	Die Matte , Die Matten Mat [anki:play:a:0]
Dichtung [anki:play:q:0]	Die Dichtung , Die Dichtungen Seal [anki:play:a:0]
Zwielicht [anki:play:q:0]	Das Zwielicht , Die Dämmerungen Twilight [anki:play:a:0]
Grunzen [anki:play:q:0]	Das Grunzen , Das Grunzen Grunt [anki:play:a:0]
Strafe [anki:play:q:0]	Die Strafe , Die Strafen Punishment [anki:play:a:0]
Clan [anki:play:q:0]	Der Clan , Die Clans Clan [anki:play:a:0]
Kupfer [anki:play:q:0]	Das Kupfer , Die Kupfer Copper [anki:play:a:0]
Trümmer [anki:play:q:0]	Die Trümmer , Die Debrises Debris [anki:play:a:0]
Maler [anki:play:q:0]	Der Maler , Die Maler Painter [anki:play:a:0]
Mathematik [anki:play:q:0]	Die Mathematik , Die Mathematik Math [anki:play:a:0]
Erkennung [anki:play:q:0]	Die Erkennung , Die Anerkennungen Recognition [anki:play:a:0]
Bedauern [anki:play:q:0]	Das Bedauern , Die Reue Regret [anki:play:a:0]
Mühle [anki:play:q:0]	Die Mühle , Die Mühlen Mill [anki:play:a:0]
Romantik [anki:play:q:0]	Die Romantik , Die Romane Romance [anki:play:a:0]
Terrasse [anki:play:q:0]	Die Terrasse , Die Innenhöfe Patio [anki:play:a:0]
Schaufel [anki:play:q:0]	Die Schaufel , Schaufeln Shovel [anki:play:a:0]
Schlafanzüge [anki:play:q:0]	Die Schlafanzüge , Die Pajamases Pajamas [anki:play:a:0]
Email [anki:play:q:0]	Die Email , Die EMails EMail [anki:play:a:0]
Taube [anki:play:q:0]	Die Taube , Die Tauben Pigeon [anki:play:a:0]
Dinosaurier [anki:play:q:0]	Der Dinosaurier , Die Dinosaurier Dinosaur [anki:play:a:0]
Branche [anki:play:q:0]	Die Branche , Die Industrie Industry [anki:play:a:0]
Betreiber [anki:play:q:0]	Der Betreiber , Die Betreiber Operator [anki:play:a:0]
Lift [anki:play:q:0]	Der Lift , Die Lifte Lift [anki:play:a:0]
Ratgeber [anki:play:q:0]	Der Ratgeber , Die Berater Counselor [anki:play:a:0]
Versammlung [anki:play:q:0]	Die Versammlung , Die Versammlungen Gathering [anki:play:a:0]
Prinzip [anki:play:q:0]	Das Prinzip , Die Grundsätze Principle [anki:play:a:0]
Drama [anki:play:q:0]	Das Drama , Die Dramen Drama [anki:play:a:0]
Küken [anki:play:q:0]	Das Küken , Die Küken Chick [anki:play:a:0]
Diagramm [anki:play:q:0]	Das Diagramm , Die Charts Chart [anki:play:a:0]
Kampagne [anki:play:q:0]	Die Kampagne , Die Kampagnen Campaign [anki:play:a:0]
Lorbeer [anki:play:q:0]	Der Lorbeer , Die Lorbeeren Laurel [anki:play:a:0]
Steak [anki:play:q:0]	Das Steak , Die Steaks Steak [anki:play:a:0]
Kriminelle [anki:play:q:0]	Der Kriminelle , Die Verbrecher Criminal [anki:play:a:0]
Globus [anki:play:q:0]	Der Globus , Die Kugeln Globe [anki:play:a:0]
Bluterguss [anki:play:q:0]	Der Bluterguss , Die Blauen Flecken Bruise [anki:play:a:0]
Töten [anki:play:q:0]	Das Töten , Die Morde Killing [anki:play:a:0]
Oper [anki:play:q:0]	Die Oper , Die Opern Opera [anki:play:a:0]
Frost [anki:play:q:0]	Der Frost , Die Fröste Frost [anki:play:a:0]
Nippel [anki:play:q:0]	Der Nippel , Die Brustwarzen Nipple [anki:play:a:0]
Pfarrer [anki:play:q:0]	Der Pfarrer , Die Pastoren Reverend [anki:play:a:0]
Trübung [anki:play:q:0]	Die Trübung , Die Trübungen Haze [anki:play:a:0]
Weihnachtslied [anki:play:q:0]	Das Weihnachtslied , Die Weihnachtslieder Carol [anki:play:a:0]
Schwäche [anki:play:q:0]	Die Schwäche , Schwächen Weakness [anki:play:a:0]
Kochen [anki:play:q:0]	Das Kochen , Die Cookings Cooking [anki:play:a:0]
Metzger [anki:play:q:0]	Der Metzger , Die Metzger Butcher [anki:play:a:0]
Würfel [anki:play:q:0]	Der Würfel , Die Würfel Cube [anki:play:a:0]
Hohl [anki:play:q:0]	Der Hohl , Die Hohlräume Hollow [anki:play:a:0]
Höcker [anki:play:q:0]	Der Höcker , Die Höcker Bump [anki:play:a:0]
Heu [anki:play:q:0]	Das Heu , Hays Hay [anki:play:a:0]
Rinde [anki:play:q:0]	Die Rinde , Die Rinden Bark [anki:play:a:0]
Überlebens [anki:play:q:0]	Die Überlebens , Die Überreste Survival [anki:play:a:0]
Etagen [anki:play:q:0]	Die Etagen , Die Kojen Bunk [anki:play:a:0]
Biegung [anki:play:q:0]	Die Biegung , Die Biegungen Bend [anki:play:a:0]
Freigabe [anki:play:q:0]	Die Freigabe , Die Zulassungen Approval [anki:play:a:0]
Cocktail [anki:play:q:0]	Der Cocktail , Die Cocktails Cocktail [anki:play:a:0]
Wettbewerb [anki:play:q:0]	Der Wettbewerb , Die Neuesten Informationen Contest [anki:play:a:0]
Paradies [anki:play:q:0]	Das Paradies , Die Paradiese Paradise [anki:play:a:0]
Rasiermesser [anki:play:q:0]	Das Rasiermesser , Die Rasierer Razor [anki:play:a:0]
Fang [anki:play:q:0]	Der Fang , Die Fänge Catch [anki:play:a:0]
Blüte [anki:play:q:0]	Die Blüte , Die Blüten Blossom [anki:play:a:0]
Pfütze [anki:play:q:0]	Die Pfütze , Die Pfützen Puddle [anki:play:a:0]
Zwiebel [anki:play:q:0]	Die Zwiebel , Die Zwiebeln Onion [anki:play:a:0]
Laser [anki:play:q:0]	Die Laser , Die Laser Laser [anki:play:a:0]
Einfluss [anki:play:q:0]	Der Einfluss , Die Einflüsse Influence [anki:play:a:0]
Sprung [anki:play:q:0]	Der Sprung , Die Sprünge Jump [anki:play:a:0]
Zement [anki:play:q:0]	Der Zement , Die Zemente Cement [anki:play:a:0]
Gelbe [anki:play:q:0]	Die Gelbe , The Ambers Amber [anki:play:a:0]
Göttin [anki:play:q:0]	Die Göttin , Die Göttinnen Goddess [anki:play:a:0]
Shack [anki:play:q:0]	The Shack , Die Baracken Shack [anki:play:a:0]
Verkäufe [anki:play:q:0]	Die Verkäufe , Die Saleses Sales [anki:play:a:0]
Drift [anki:play:q:0]	Die Drift , Die Drifts Drift [anki:play:a:0]
Kämpfe [anki:play:q:0]	Die Kämpfe , Die Kämpfe Fighting [anki:play:a:0]
Geflecht [anki:play:q:0]	Das Geflecht , Die Zöpfe Braid [anki:play:a:0]
Würde [anki:play:q:0]	Die Würde , Die Dignität Dignity [anki:play:a:0]
Zitrone [anki:play:q:0]	Die Zitrone , Die Zitronen Lemon [anki:play:a:0]
Clown [anki:play:q:0]	Der Clown , Die Clowns Clown [anki:play:a:0]
Brille [anki:play:q:0]	Die Brille , Die Schutzbrillen Goggle [anki:play:a:0]
Zerstörung [anki:play:q:0]	Die Zerstörung , Die Zerstörungen Destruction [anki:play:a:0]
Ausnahme [anki:play:q:0]	Die Ausnahme , Die Ausnahmen Exception [anki:play:a:0]
Pfirsich [anki:play:q:0]	Der Pfirsich , Die Pfirsiche Peach [anki:play:a:0]
Wasch [anki:play:q:0]	Die Wasch , Die Wasch Wash [anki:play:a:0]
Befreiung [anki:play:q:0]	Die Befreiung , Die Freigaben Release [anki:play:a:0]
Spion [anki:play:q:0]	Der Spion , Die Spione Spy [anki:play:a:0]
Bh [anki:play:q:0]	Der Bh , Die Bhs Bra [anki:play:a:0]
Überbleibsel [anki:play:q:0]	Die Überbleibsel , Die Remainses Remains [anki:play:a:0]
Logik [anki:play:q:0]	Die Logik , Die Logik Logic [anki:play:a:0]
Joint [anki:play:q:0]	Der Joint , Die Gelenke Joint [anki:play:a:0]
Krug [anki:play:q:0]	Der Krug , Die Krüge Pitcher [anki:play:a:0]
Perspektive [anki:play:q:0]	Die Perspektive , Die Perspektiven Perspective [anki:play:a:0]
Ernte [anki:play:q:0]	Die Ernte , Die Ernte Crop [anki:play:a:0]
Diplom [anki:play:q:0]	Der Diplom , Die Absolventen Graduate [anki:play:a:0]
Chor [anki:play:q:0]	Der Chor , Die Chöre Chorus [anki:play:a:0]
Überlebende [anki:play:q:0]	Der Überlebende , Die Überlebenden Survivor [anki:play:a:0]
Bezahlung [anki:play:q:0]	Die Bezahlung , Zahlungen Payment [anki:play:a:0]
Wette [anki:play:q:0]	Die Wette , Die Wetten Bet [anki:play:a:0]
Rache [anki:play:q:0]	Die Rache , Die Rache Revenge [anki:play:a:0]
Ältere [anki:play:q:0]	Der Ältere , Die Ältesten Elder [anki:play:a:0]
Ingwer [anki:play:q:0]	Der Ingwer , Die Ingwer Ginger [anki:play:a:0]
Chirurg [anki:play:q:0]	Der Chirurg , Die Chirurgen Surgeon [anki:play:a:0]
Bindestrich [anki:play:q:0]	Der Bindestrich , Die Striche Dash [anki:play:a:0]
Sandale [anki:play:q:0]	Die Sandale , Die Sandalen Sandal [anki:play:a:0]
Hass [anki:play:q:0]	Der Hass , Die Hass Hatred [anki:play:a:0]
Abfahrt [anki:play:q:0]	Die Abfahrt , Die Abfahrten Departure [anki:play:a:0]
Umriss [anki:play:q:0]	Der Umriss , Die Umrisse Outline [anki:play:a:0]
Rabe [anki:play:q:0]	Der Rabe , Die Raben Raven [anki:play:a:0]
Läufer [anki:play:q:0]	Der Läufer , Die Läufer Runner [anki:play:a:0]
Übersetzung [anki:play:q:0]	Die Übersetzung , Die Übersetzungen Translation [anki:play:a:0]
Hauptquartier [anki:play:q:0]	Das Hauptquartier , Die Headquarterses Headquarters [anki:play:a:0]
Qual [anki:play:q:0]	Die Qual , Die Qualen Agony [anki:play:a:0]
Turnschuhe [anki:play:q:0]	Die Turnschuhe , Die Sneakerses Sneakers [anki:play:a:0]
Terminal [anki:play:q:0]	Das Terminal , Die Endgeräte Terminal [anki:play:a:0]
Erwartung [anki:play:q:0]	Die Erwartung , Die Erwartungen Expectation [anki:play:a:0]
Weide [anki:play:q:0]	Die Weide , Die Weiden Pasture [anki:play:a:0]
Konsole [anki:play:q:0]	Die Konsole , Die Konsolen Console [anki:play:a:0]
Streik [anki:play:q:0]	Der Streik , Die Streiks Strike [anki:play:a:0]
Rettung [anki:play:q:0]	Die Rettung , Die Rettungsaktionen Rescue [anki:play:a:0]
Abzeichen [anki:play:q:0]	Das Abzeichen , Badges Badge [anki:play:a:0]
Foyer [anki:play:q:0]	Das Foyer , Die Foyeies Foyer [anki:play:a:0]
Pastor [anki:play:q:0]	Der Pastor , Die Pastoren Pastor [anki:play:a:0]
Puzzle [anki:play:q:0]	Das Puzzle , Die Rätsel Puzzle [anki:play:a:0]
Wohlfahrt [anki:play:q:0]	Die Wohlfahrt , Die Wohltätigkeitsorganisationen Charity [anki:play:a:0]
Philosophie [anki:play:q:0]	Die Philosophie , Die Philosophien Philosophy [anki:play:a:0]
Bis [anki:play:q:0]	Die Bis , Die Höhen Up [anki:play:a:0]
Neffe [anki:play:q:0]	Der Neffe , Die Neffen Nephew [anki:play:a:0]
Aufsatz [anki:play:q:0]	Der Aufsatz , Die Aufsätze Essay [anki:play:a:0]
Reparatur [anki:play:q:0]	Die Reparatur , Die Reparaturen Repair [anki:play:a:0]
Mix [anki:play:q:0]	Der Mix , Die Mixs Mix [anki:play:a:0]
Mob [anki:play:q:0]	Der Mob , Die Mobs Mob [anki:play:a:0]
Barriere [anki:play:q:0]	Die Barriere , Die Barrieren Barrier [anki:play:a:0]
Güte [anki:play:q:0]	Die Güte , Die Goodnesses Goodness [anki:play:a:0]
Scout [anki:play:q:0]	Der Scout , Die Pfadfinder Scout [anki:play:a:0]
Wichtigkeit [anki:play:q:0]	Die Wichtigkeit , Die Wichtigkeiten Importance [anki:play:a:0]
Beihilfen [anki:play:q:0]	Die Beihilfen , Die Beihilfen Aid [anki:play:a:0]
Mikrofon [anki:play:q:0]	Das Mikrofon , Die Mikrofone Microphone [anki:play:a:0]
Etikett [anki:play:q:0]	Das Etikett , Die Etiketten Label [anki:play:a:0]
Pfeffer [anki:play:q:0]	Der Pfeffer , Die Paprika Pepper [anki:play:a:0]
Kojote [anki:play:q:0]	Der Kojote , Die Kojoten Coyote [anki:play:a:0]
Lehren [anki:play:q:0]	Das Lehren , Die Lehren Teaching [anki:play:a:0]
Brennvorgang [anki:play:q:0]	Der Brennvorgang , Die Verbrennungen Burn [anki:play:a:0]
Weste [anki:play:q:0]	Die Weste , Die Westen Vest [anki:play:a:0]
Pony [anki:play:q:0]	Das Pony , Die Ponys Pony [anki:play:a:0]
Keuchen [anki:play:q:0]	Das Keuchen , Die Keuchen Gasp [anki:play:a:0]
Ironie [anki:play:q:0]	Die Ironie , Die Ironien Irony [anki:play:a:0]
Auszeichnung [anki:play:q:0]	Die Auszeichnung , Die Auszeichnungen Award [anki:play:a:0]
Traube [anki:play:q:0]	Die Traube , Die Trauben Grape [anki:play:a:0]
Zögern [anki:play:q:0]	Das Zögern , Die Bedenken Hesitation [anki:play:a:0]
Taverne [anki:play:q:0]	Die Taverne , Die Tavernen Tavern [anki:play:a:0]
Segel [anki:play:q:0]	Das Segel , Die Segel Sail [anki:play:a:0]
Silhouette [anki:play:q:0]	Die Silhouette , Die Silhouetten Silhouette [anki:play:a:0]
Institut [anki:play:q:0]	Das Institut , Die Institute Institute [anki:play:a:0]
Lügner [anki:play:q:0]	Der Lügner , Die Lügner Liar [anki:play:a:0]
Technik [anki:play:q:0]	Die Technik , Die Techniken Technique [anki:play:a:0]
Index [anki:play:q:0]	Der Index , Die Indexs Index [anki:play:a:0]
Brett [anki:play:q:0]	Das Brett , Die Bretter Plank [anki:play:a:0]
Ruck [anki:play:q:0]	Der Ruck , Die Idioten Jerk [anki:play:a:0]
Wachstum [anki:play:q:0]	Das Wachstum , Die Wucherungen Growth [anki:play:a:0]
Strumpf [anki:play:q:0]	Der Strumpf , Die Strümpfe Stocking [anki:play:a:0]
Schwärze [anki:play:q:0]	Die Schwärze , Die Schwärzen Blackness [anki:play:a:0]
Armband [anki:play:q:0]	Das Armband , Die Armbänder Bracelet [anki:play:a:0]
Diät [anki:play:q:0]	Die Diät , Die Diäten Diet [anki:play:a:0]
Beton [anki:play:q:0]	Der Beton , Die Betone Concrete [anki:play:a:0]
Kontrast [anki:play:q:0]	Der Kontrast , Die Gegensätze Contrast [anki:play:a:0]
Banner [anki:play:q:0]	Das Banner , Die Banner Banner [anki:play:a:0]
Widerstand [anki:play:q:0]	Der Widerstand , Die Widerstände Resistance [anki:play:a:0]
Aufenthalt [anki:play:q:0]	Der Aufenthalt , Die Aufenthalte Stay [anki:play:a:0]
Haltung [anki:play:q:0]	Die Haltung , Die Haltungen Posture [anki:play:a:0]
Wodka [anki:play:q:0]	Der Wodka , Die Wodkas Vodka [anki:play:a:0]
Album [anki:play:q:0]	Das Album , Die Alben Album [anki:play:a:0]
Ära [anki:play:q:0]	Die Ära , Die Epochen Era [anki:play:a:0]
Bekanntschaft [anki:play:q:0]	Die Bekanntschaft , Die Bekannten Acquaintance [anki:play:a:0]
Revolution [anki:play:q:0]	Die Revolution , Die Revolutionen Revolution [anki:play:a:0]
Nap [anki:play:q:0]	Der Nap , Die Noppen Nap [anki:play:a:0]
Schleier [anki:play:q:0]	Der Schleier , Die Schleier Veil [anki:play:a:0]
Schauspiel [anki:play:q:0]	Das Schauspiel , Die Brille Spectacle [anki:play:a:0]
Kopfhaut [anki:play:q:0]	Die Kopfhaut , Die Kopfhaut Scalp [anki:play:a:0]
Stechpalme [anki:play:q:0]	Die Stechpalme , The Hollies Holly [anki:play:a:0]
Gewinner [anki:play:q:0]	Der Gewinner , Die Gewinner Winner [anki:play:a:0]
Appetit [anki:play:q:0]	Der Appetit , Die Appetit Appetite [anki:play:a:0]
Efeu [anki:play:q:0]	Der Efeu , Die Efeu Ivy [anki:play:a:0]
Nichte [anki:play:q:0]	Die Nichte , Die Nichten Niece [anki:play:a:0]
Galaxie [anki:play:q:0]	Die Galaxie , Die Galaxien Galaxy [anki:play:a:0]
Verrücktheit [anki:play:q:0]	Die Verrücktheit , Die Verrücktheiten Madness [anki:play:a:0]
Bäcker [anki:play:q:0]	Der Bäcker , Die Bäcker Baker [anki:play:a:0]
Virus [anki:play:q:0]	Das Virus , Die Viren Virus [anki:play:a:0]
Leiden [anki:play:q:0]	Das Leiden , Die Leiden Suffering [anki:play:a:0]
Schlitz [anki:play:q:0]	Der Schlitz , Die Schlitze Slot [anki:play:a:0]
Ordner [anki:play:q:0]	Der Ordner , Die Hefte Folder [anki:play:a:0]
Bekenntnis [anki:play:q:0]	Das Bekenntnis , Die Geständnisse Confession [anki:play:a:0]
Dessert [anki:play:q:0]	Das Dessert , Die Desserts Dessert [anki:play:a:0]
Gewinn [anki:play:q:0]	Der Gewinn , Die Gewinne Profit [anki:play:a:0]
Enkel [anki:play:q:0]	Der Enkel , Die Enkelkinder Grandchild [anki:play:a:0]
Tratsch [anki:play:q:0]	Der Tratsch , Der Klatsch Gossip [anki:play:a:0]
Stute [anki:play:q:0]	Die Stute , Die Stuten Mare [anki:play:a:0]
Dna [anki:play:q:0]	Die Dna , Die Dnas Dna [anki:play:a:0]
Besen [anki:play:q:0]	Der Besen , Die Besen Broom [anki:play:a:0]
Huf [anki:play:q:0]	Der Huf , Die Hufe Hoof [anki:play:a:0]
Sensor [anki:play:q:0]	Der Sensor , Die Sensoren Sensor [anki:play:a:0]
Gelehrte [anki:play:q:0]	Der Gelehrte , Die Gelehrten Scholar [anki:play:a:0]
Therapie [anki:play:q:0]	Die Therapie , Die Therapie Therapy [anki:play:a:0]
Erdnuss [anki:play:q:0]	Die Erdnuss , Die Erdnüsse Peanut [anki:play:a:0]
Schlagzeile [anki:play:q:0]	Die Schlagzeile , Schlagzeilen Headline [anki:play:a:0]
Speck [anki:play:q:0]	Der Speck , Die Speck Bacon [anki:play:a:0]
Heck [anki:play:q:0]	Das Heck , Die Hecks Stern [anki:play:a:0]
Geige [anki:play:q:0]	Die Geige , Die Violinen Violin [anki:play:a:0]
Pest [anki:play:q:0]	Die Pest , Die Plagen Plague [anki:play:a:0]
Unschärfe [anki:play:q:0]	Die Unschärfe , Die Unschärfen Blur [anki:play:a:0]
Zwischenzeit [anki:play:q:0]	Die Zwischenzeit , Die Zwischenzeiten Meantime [anki:play:a:0]
Diakon [anki:play:q:0]	Der Diakon , Die Diakone Deacon [anki:play:a:0]
Lanze [anki:play:q:0]	Die Lanze , Die Lanzen Lance [anki:play:a:0]
Festnahme [anki:play:q:0]	Die Festnahme , Die Verhaftungen Arrest [anki:play:a:0]
Banane [anki:play:q:0]	Die Banane , Die Bananen Banana [anki:play:a:0]
Gin [anki:play:q:0]	Der Gin , Die Gins Gin [anki:play:a:0]
Hai [anki:play:q:0]	Der Hai , Die Haie Shark [anki:play:a:0]
Vorbereitung [anki:play:q:0]	Die Vorbereitung , Die Vorbereitungen Preparation [anki:play:a:0]
Kratz [anki:play:q:0]	Die Kratz , Die Kratzer Scratch [anki:play:a:0]
Verband [anki:play:q:0]	Der Verband , Die Verbände Dressing [anki:play:a:0]
Unterschrift [anki:play:q:0]	Die Unterschrift , Unterschriften Signature [anki:play:a:0]
Admiral [anki:play:q:0]	Der Admiral , Die Admirale Admiral [anki:play:a:0]
Analyse [anki:play:q:0]	Die Analyse , Die Analysisies Analysis [anki:play:a:0]
Regenbogen [anki:play:q:0]	Der Regenbogen , Die Regenbogen Rainbow [anki:play:a:0]
Eidechse [anki:play:q:0]	Die Eidechse , Die Eidechsen Lizard [anki:play:a:0]
Zwerg [anki:play:q:0]	Der Zwerg , Die Zwerge Dwarf [anki:play:a:0]
Stress [anki:play:q:0]	Der Stress , Die Belastungen Stress [anki:play:a:0]
Hausaufgabe [anki:play:q:0]	Die Hausaufgabe , Die Hausaufgaben Homework [anki:play:a:0]
Mischung [anki:play:q:0]	Die Mischung , Die Mischungen Mixture [anki:play:a:0]
Vers [anki:play:q:0]	Der Vers , Die Verse Verse [anki:play:a:0]
Überzeugung [anki:play:q:0]	Die Überzeugung , Die Überzeugungen Conviction [anki:play:a:0]
Rover [anki:play:q:0]	Der Rover , Die Rover Rover [anki:play:a:0]
Zaunkönig [anki:play:q:0]	Der Zaunkönig , Die Zaunkönige Wren [anki:play:a:0]
Expedition [anki:play:q:0]	Die Expedition , Die Expeditionen Expedition [anki:play:a:0]
Belohnung [anki:play:q:0]	Die Belohnung , Die Belohnungen Reward [anki:play:a:0]
Säulen [anki:play:q:0]	Die Säulen , Die Säulen Pillar [anki:play:a:0]
Marmelade [anki:play:q:0]	Die Marmelade , Die Marmeladen Jam [anki:play:a:0]
Schnaps [anki:play:q:0]	Der Schnaps , Die Brände Brandy [anki:play:a:0]
Residenz [anki:play:q:0]	Die Residenz , Die Residenzen Residence [anki:play:a:0]
Baron [anki:play:q:0]	Der Baron , Die Barone Baron [anki:play:a:0]
Komplex [anki:play:q:0]	Der Komplex , Die Complexs Complex [anki:play:a:0]
Kandidat [anki:play:q:0]	Der Kandidat , Die Kandidaten Candidate [anki:play:a:0]
Triumph [anki:play:q:0]	Der Triumph , Die Triumphes Triumph [anki:play:a:0]
Wendung [anki:play:q:0]	Die Wendung , Die Drehungen Twist [anki:play:a:0]
Skizze [anki:play:q:0]	Die Skizze , Die Skizzen Sketch [anki:play:a:0]
Register [anki:play:q:0]	Das Register , Die Register Register [anki:play:a:0]
Herzschlag [anki:play:q:0]	Der Herzschlag , Die Herzschläge Heartbeat [anki:play:a:0]
Cafeteria [anki:play:q:0]	Die Cafeteria , Die Cafeterien Cafeteria [anki:play:a:0]
Gebühr [anki:play:q:0]	Die Gebühr , Die Gebühren Fee [anki:play:a:0]
Hang [anki:play:q:0]	Die Hang , Die Hänge Hillside [anki:play:a:0]
Labyrinth [anki:play:q:0]	Das Labyrinth , Die Labyrinthe Maze [anki:play:a:0]
Fischer [anki:play:q:0]	Der Fischer , Das Fishermans Fisherman [anki:play:a:0]
Brummen [anki:play:q:0]	Das Brummen , Die Summt Hum [anki:play:a:0]
Kätzchen [anki:play:q:0]	Das Kätzchen , Die Kätzchen Kitten [anki:play:a:0]
Dread [anki:play:q:0]	The Dread , Die Dreads Dread [anki:play:a:0]
Substanz [anki:play:q:0]	Die Substanz , Die Substanzen Substance [anki:play:a:0]
Knall [anki:play:q:0]	Der Knall , Der Pony Bang [anki:play:a:0]
Dolch [anki:play:q:0]	Der Dolch , Die Dolche Dagger [anki:play:a:0]
Con [anki:play:q:0]	Das Con , Die Nachteile Con [anki:play:a:0]
Einsamkeit [anki:play:q:0]	Die Einsamkeit , Die Einsamkeiten Loneliness [anki:play:a:0]
Motorrad [anki:play:q:0]	Das Motorrad , Die Motorräder Motorcycle [anki:play:a:0]
Staunen [anki:play:q:0]	Das Staunen , Die Amazements Amazement [anki:play:a:0]
Peer [anki:play:q:0]	Die Peer , Die Peers Peer [anki:play:a:0]
Tech [anki:play:q:0]	Die Tech , Die Teches Tech [anki:play:a:0]
Beleidigung [anki:play:q:0]	Die Beleidigung , Die Beleidigungen Insult [anki:play:a:0]
Kapazität [anki:play:q:0]	Die Kapazität , Die Kapazität Capacity [anki:play:a:0]
Ehrfurcht [anki:play:q:0]	Die Ehrfurcht , Die Awes Awe [anki:play:a:0]
Chili [anki:play:q:0]	Die Chili , Die Chilis Chili [anki:play:a:0]
Lodge [anki:play:q:0]	Die Lodge , Die Logen Lodge [anki:play:a:0]
Clip [anki:play:q:0]	Der Clip , Die Clips Clip [anki:play:a:0]
Limousine [anki:play:q:0]	Die Limousine , Die Limousinen Limo [anki:play:a:0]
Mücke [anki:play:q:0]	Die Mücke , Die Mücken Mosquito [anki:play:a:0]
Shake [anki:play:q:0]	Der Shake , Die Shakes Shake [anki:play:a:0]
Festmahl [anki:play:q:0]	Das Festmahl , Die Feste Feast [anki:play:a:0]
Casino [anki:play:q:0]	Das Casino , Die Casinos Casino [anki:play:a:0]
Erbse [anki:play:q:0]	Die Erbse , Die Erbsen Pea [anki:play:a:0]
Murmeln [anki:play:q:0]	Das Murmeln , Das Murmeln Murmur [anki:play:a:0]
Konflikt [anki:play:q:0]	Der Konflikt , Die Konflikte Conflict [anki:play:a:0]
Genosse [anki:play:q:0]	Der Genosse , Die Genossen Comrade [anki:play:a:0]
Schwangerschaft [anki:play:q:0]	Die Schwangerschaft , Schwangerschaften Pregnancy [anki:play:a:0]
Verdächtige [anki:play:q:0]	Der Verdächtige , Die Verdächtigen Suspect [anki:play:a:0]
Zusammentreffen [anki:play:q:0]	Das Zusammentreffen , Die Zufälle Coincidence [anki:play:a:0]
Waldläufer [anki:play:q:0]	Der Waldläufer , Die Ranger Ranger [anki:play:a:0]
Karikatur [anki:play:q:0]	Die Karikatur , Die Karikaturen Cartoon [anki:play:a:0]
Mitbewohner [anki:play:q:0]	Der Mitbewohner , Die Mitbewohner Roommate [anki:play:a:0]
Freundlichkeit [anki:play:q:0]	Die Freundlichkeit , Die Freundlichkeiten Kindness [anki:play:a:0]
Kreuzer [anki:play:q:0]	Der Kreuzer , Die Kreuzer Cruiser [anki:play:a:0]
Bramme [anki:play:q:0]	Die Bramme , Die Brammen Slab [anki:play:a:0]
Gewissen [anki:play:q:0]	Das Gewissen , Das Gewissen Conscience [anki:play:a:0]
Cheer [anki:play:q:0]	Die Cheer , Der Jubel Cheer [anki:play:a:0]
Konus [anki:play:q:0]	Der Konus , Die Kegel Cone [anki:play:a:0]
Elfenbein [anki:play:q:0]	Das Elfenbein , Die Elfenbeinarbeiten Ivory [anki:play:a:0]
Penner [anki:play:q:0]	Der Penner , Die Bums Bum [anki:play:a:0]
Donna [anki:play:q:0]	Die Donna , The Donnas Donna [anki:play:a:0]
Reservierung [anki:play:q:0]	Die Reservierung , Reservierungen Reservation [anki:play:a:0]
Unterhaltung [anki:play:q:0]	Die Unterhaltung , Die Unterhaltungen Entertainment [anki:play:a:0]
Krabbe [anki:play:q:0]	Die Krabbe , Die Krabben Crab [anki:play:a:0]
Stöhnen [anki:play:q:0]	Das Stöhnen , Das Stöhnen Groan [anki:play:a:0]
Akademie [anki:play:q:0]	Die Akademie , Die Akademien Academy [anki:play:a:0]
Sehnsucht [anki:play:q:0]	Die Sehnsucht , Die Sehnsüchte Longing [anki:play:a:0]
Kip [anki:play:q:0]	Die Kip , Die Kips Kip [anki:play:a:0]
Bohrer [anki:play:q:0]	Der Bohrer , Die Bohrer Drill [anki:play:a:0]
Gepäck [anki:play:q:0]	Das Gepäck , Die Den Gepäck Luggage [anki:play:a:0]
Baldachin [anki:play:q:0]	Der Baldachin , Die Baldachine Canopy [anki:play:a:0]
Nervenkitzel [anki:play:q:0]	Der Nervenkitzel , Den Nervenkitzel Thrill [anki:play:a:0]
Tugend [anki:play:q:0]	Die Tugend , Die Tugenden Virtue [anki:play:a:0]
Schornstein [anki:play:q:0]	Der Schornstein , Die Schornsteine Chimney [anki:play:a:0]
Anker [anki:play:q:0]	Die Anker , Die Anker Anchor [anki:play:a:0]
Harmonie [anki:play:q:0]	Die Harmonie , Die Harmonien Harmony [anki:play:a:0]
Ahorn [anki:play:q:0]	Das Ahorn , Die Ahorne Maple [anki:play:a:0]
Kaninchen [anki:play:q:0]	Das Kaninchen , Die Hasen Bunny [anki:play:a:0]
Modus [anki:play:q:0]	Der Modus , Die Modi Mode [anki:play:a:0]
Thron [anki:play:q:0]	Der Thron , Die Throne Throne [anki:play:a:0]
Antrag [anki:play:q:0]	Der Antrag , Anwendungen Application [anki:play:a:0]
Physik [anki:play:q:0]	Die Physik , Die Physicsies Physics [anki:play:a:0]
Neon [anki:play:q:0]	Das Neon , Die Neons Neon [anki:play:a:0]
Luftschleuse [anki:play:q:0]	Die Luftschleuse , Die Luftschleusen Airlock [anki:play:a:0]
Ermüdungs [anki:play:q:0]	Die Ermüdungs , Die Strapazen Fatigue [anki:play:a:0]
Danksagung [anki:play:q:0]	Die Danksagung , Die Danksagungen Thanksgiving [anki:play:a:0]
Manuskript [anki:play:q:0]	Das Manuskript , Die Handschriften Manuscript [anki:play:a:0]
Basis [anki:play:q:0]	Die Basis , Die Basises Basis [anki:play:a:0]
Denkmal [anki:play:q:0]	Das Denkmal , Gedenkstätten Memorial [anki:play:a:0]
Japaner [anki:play:q:0]	Die Japaner , Die Japaneses Japanese [anki:play:a:0]
Engineering [anki:play:q:0]	Das Engineering , Die Engineerings Engineering [anki:play:a:0]
Linke [anki:play:q:0]	Die Linke , Die Linke Left [anki:play:a:0]
Bronze [anki:play:q:0]	Die Bronze , Die Bronzen Bronze [anki:play:a:0]
Assoziation [anki:play:q:0]	Die Assoziation , Die Verbände Association [anki:play:a:0]
Marker [anki:play:q:0]	Der Marker , Die Marker Marker [anki:play:a:0]
Beute [anki:play:q:0]	Die Beute , Die Beute Prey [anki:play:a:0]
Episode [anki:play:q:0]	Die Episode , Die Episoden Episode [anki:play:a:0]
Vakuum [anki:play:q:0]	Das Vakuum , Die Staubsauger Vacuum [anki:play:a:0]
Kathedrale [anki:play:q:0]	Die Kathedrale , Die Kathedralen Cathedral [anki:play:a:0]
Management [anki:play:q:0]	Das Management , Die Unternehmensleitungen Management [anki:play:a:0]
Nach [anki:play:q:0]	Die Nach Unten , Die Tiefen Down [anki:play:a:0]
Kontinent [anki:play:q:0]	Der Kontinent , Die Kontinente Continent [anki:play:a:0]
Freiwillige [anki:play:q:0]	Die Freiwillige , Die Freiwilligen Volunteer [anki:play:a:0]
Saum [anki:play:q:0]	Der Saum , Die Säume Hem [anki:play:a:0]
Erwähnung [anki:play:q:0]	Die Erwähnung , Nennungen Mention [anki:play:a:0]
Lust [anki:play:q:0]	Die Lust , Die Begierden Lust [anki:play:a:0]
Kichern [anki:play:q:0]	Die Kichern , Das Kichern Giggle [anki:play:a:0]
Klassenkameraden [anki:play:q:0]	Die Klassenkameraden , Die Klassenkameraden Classmate [anki:play:a:0]
Reinigung [anki:play:q:0]	Die Reinigung , Die Reinigungen Cleaning [anki:play:a:0]
Rezeptionist [anki:play:q:0]	Der Rezeptionist , An Der Rezeption Receptionist [anki:play:a:0]
Anrufer [anki:play:q:0]	Der Anrufer , Die Anrufer Caller [anki:play:a:0]
Streben [anki:play:q:0]	Das Streben , Die Beschäftigungen Pursuit [anki:play:a:0]
Verachtung [anki:play:q:0]	Die Verachtung , Die Geringschätzungen Contempt [anki:play:a:0]
Großeltern [anki:play:q:0]	Die Großeltern , Die Großeltern Grandparent [anki:play:a:0]
Tat [anki:play:q:0]	Die Tat , Die Taten Deed [anki:play:a:0]
Artefakt [anki:play:q:0]	Das Artefakt , Die Artefakte Artifact [anki:play:a:0]
Falten [anki:play:q:0]	Die Falten , Die Falten Wrinkle [anki:play:a:0]
Stich [anki:play:q:0]	Der Stich , Die Stiche Pang [anki:play:a:0]
Italienische [anki:play:q:0]	Die Italienische , Die Italiener Italian [anki:play:a:0]
Ewigkeit [anki:play:q:0]	Die Ewigkeit , Die Ewigkeit Eternity [anki:play:a:0]
Schiefer [anki:play:q:0]	Der Schiefer , Die Schiefertafeln Slate [anki:play:a:0]
Ankündigung [anki:play:q:0]	Die Ankündigung , Die Ankündigungen Announcement [anki:play:a:0]
Motiv [anki:play:q:0]	Das Motiv , Die Motive Motive [anki:play:a:0]
Mechaniker [anki:play:q:0]	Der Mechaniker , Die Mechanik Mechanic [anki:play:a:0]
Verbündete [anki:play:q:0]	Der Verbündete , Alliierten Ally [anki:play:a:0]
Vase [anki:play:q:0]	Die Vase , Die Vasen Vase [anki:play:a:0]
Verkäufer [anki:play:q:0]	Der Verkäufer , Die Salesmans Salesman [anki:play:a:0]
Therapeut [anki:play:q:0]	Der Therapeut , Die Therapeuten Therapist [anki:play:a:0]
Bandage [anki:play:q:0]	Die Bandage , Die Bandagen Bandage [anki:play:a:0]
Schinken [anki:play:q:0]	Der Schinken , Die Schinken Ham [anki:play:a:0]
Fuhrmann [anki:play:q:0]	Der Fuhrmann , Die Fuhr Carter [anki:play:a:0]
Investition [anki:play:q:0]	Die Investition , Die Investitionen Investment [anki:play:a:0]
Kalender [anki:play:q:0]	Der Kalender , Die Kalender Calendar [anki:play:a:0]
Offenbarung [anki:play:q:0]	Die Offenbarung , Die Enthüllungen Revelation [anki:play:a:0]
Pfannkuchen [anki:play:q:0]	Der Pfannkuchen , Die Pfannkuchen Pancake [anki:play:a:0]
Asteroid [anki:play:q:0]	Der Asteroid , Die Asteroiden Asteroid [anki:play:a:0]
Postkarte [anki:play:q:0]	Die Postkarte , Die Postkarten Postcard [anki:play:a:0]
Kleidungsstück [anki:play:q:0]	Das Kleidungsstück , Die Kleidungsstücke Garment [anki:play:a:0]
Bestimmung [anki:play:q:0]	Die Bestimmung , Die Bestimmungen Determination [anki:play:a:0]
Traktor [anki:play:q:0]	Der Traktor , Die Traktoren Tractor [anki:play:a:0]
Beere [anki:play:q:0]	Die Beere , Die Beeren Berry [anki:play:a:0]
Straftat [anki:play:q:0]	Die Straftat , Die Straftaten Offense [anki:play:a:0]
Einleitung [anki:play:q:0]	Die Einleitung , Die Einleitungen Introduction [anki:play:a:0]
Butler [anki:play:q:0]	Der Butler , The Butlers Butler [anki:play:a:0]
Husten [anki:play:q:0]	Der Husten , Die Coughes Cough [anki:play:a:0]
Granit [anki:play:q:0]	Der Granit , Die Granite Granite [anki:play:a:0]
Botschafter [anki:play:q:0]	Der Botschafter , Die Botschafter Ambassador [anki:play:a:0]
Kompliment [anki:play:q:0]	Das Kompliment , Die Komplimente Compliment [anki:play:a:0]
Karton [anki:play:q:0]	Der Karton , Die Schachteln Carton [anki:play:a:0]
Türklingel [anki:play:q:0]	Die Türklingel , Die Türklingeln Doorbell [anki:play:a:0]
Gewissheit [anki:play:q:0]	Die Gewissheit , Die Gewissheiten Certainty [anki:play:a:0]
Politiker [anki:play:q:0]	Der Politiker , Die Politiker Politician [anki:play:a:0]
Dankbarkeit [anki:play:q:0]	Die Dankbarkeit , --- Gratitude [anki:play:a:0]
Jetzige [anki:play:q:0]	Die Jetzige , Die Ströme Current [anki:play:a:0]
Dunkel [anki:play:q:0]	Das Dunkel , Die Düsterkeit Gloom [anki:play:a:0]
Putz [anki:play:q:0]	Der Putz , Die Pflaster Plaster [anki:play:a:0]
Siedlung [anki:play:q:0]	Die Siedlung , Die Siedlungen Settlement [anki:play:a:0]
Chop [anki:play:q:0]	Die Chop , Die Koteletts Chop [anki:play:a:0]
Mordkommission [anki:play:q:0]	Die Mordkommission , Die Tötungsdelikte Homicide [anki:play:a:0]
Aluminium [anki:play:q:0]	Die Aluminium , Die Aluminums Aluminum [anki:play:a:0]
Boulevard [anki:play:q:0]	Der Boulevard , Die Boulevards Boulevard [anki:play:a:0]
Schwimmer [anki:play:q:0]	Der Schwimmer , Die Schwimmer Float [anki:play:a:0]
Rückzug [anki:play:q:0]	Der Rückzug , Die Exerzitien Retreat [anki:play:a:0]
Schnittpunkt [anki:play:q:0]	Der Schnittpunkt , Die Schnittpunkte Intersection [anki:play:a:0]
Regelung [anki:play:q:0]	Die Regelung , Die Systeme Scheme [anki:play:a:0]
Leere [anki:play:q:0]	Die Leere , Die Emptinesses Emptiness [anki:play:a:0]
Verlag [anki:play:q:0]	Der Verlag , Die Verleger Publisher [anki:play:a:0]
Zirkus [anki:play:q:0]	Der Zirkus , Die Zirkusse Circus [anki:play:a:0]
Abmessung [anki:play:q:0]	Die Abmessung , Die Dimensionen Dimension [anki:play:a:0]
Tierpark [anki:play:q:0]	Der Tierpark , Die Zoos Zoo [anki:play:a:0]
Bote [anki:play:q:0]	Der Bote , Die Boten Messenger [anki:play:a:0]
Beau [anki:play:q:0]	Das Beau , Die Beaus Beau [anki:play:a:0]
Gewirr [anki:play:q:0]	Das Gewirr , Die Tangles Tangle [anki:play:a:0]
Strategie [anki:play:q:0]	Die Strategie , Die Strategien Strategy [anki:play:a:0]
Geschäftsmann [anki:play:q:0]	Der Geschäftsmann , Die Business Businessman [anki:play:a:0]
Pod [anki:play:q:0]	The Pod , Die Schoten Pod [anki:play:a:0]
Abfluss [anki:play:q:0]	Der Abfluss , Die Drain Drain [anki:play:a:0]
Erdbeere [anki:play:q:0]	Die Erdbeere , Die Erdbeeren Strawberry [anki:play:a:0]
Jahrestag [anki:play:q:0]	Der Jahrestag , Die Jahrestage Anniversary [anki:play:a:0]
Fernglas [anki:play:q:0]	Das Fernglas , Die Binocularses Binoculars [anki:play:a:0]
Kluft [anki:play:q:0]	Die Kluft , Die Buchten Gulf [anki:play:a:0]
Disziplin [anki:play:q:0]	Die Disziplin , Die Disziplinen Discipline [anki:play:a:0]
Hecke [anki:play:q:0]	Die Hecke , Die Hecken Hedge [anki:play:a:0]
Einkommen [anki:play:q:0]	Das Einkommen , Die Einkommen Income [anki:play:a:0]
Mythos [anki:play:q:0]	Der Mythos , Die Mythen Myth [anki:play:a:0]
Verschluss [anki:play:q:0]	Der Verschluss , Die Fensterläden Shutter [anki:play:a:0]
Floß [anki:play:q:0]	Das Floß , Die Flöße Raft [anki:play:a:0]
Arzt [anki:play:q:0]	Der Arzt , Die Ärzte Physician [anki:play:a:0]
Ehrgeiz [anki:play:q:0]	Der Ehrgeiz , Die Ambitionen Ambition [anki:play:a:0]
Kamel [anki:play:q:0]	Das Kamel , Die Kamele Camel [anki:play:a:0]
Säure [anki:play:q:0]	Die Säure , Die Säuren Acid [anki:play:a:0]
Becken [anki:play:q:0]	Das Becken , Die Becken Basin [anki:play:a:0]
Nachthemd [anki:play:q:0]	Das Nachthemd , Die Nachthemden Nightgown [anki:play:a:0]
Cockpit [anki:play:q:0]	Das Cockpit , Die Cockpits Cockpit [anki:play:a:0]
Wrack [anki:play:q:0]	Das Wrack , Die Wracks Wreck [anki:play:a:0]
Perücke [anki:play:q:0]	Die Perücke , Die Perücken Wig [anki:play:a:0]
Recorder [anki:play:q:0]	Der Recorder , Die Rekorder Recorder [anki:play:a:0]
Schweinefleisch [anki:play:q:0]	Das Schweinefleisch , Die Porks Pork [anki:play:a:0]
Prüfung [anki:play:q:0]	Die Prüfung , Die Prüfungen Exam [anki:play:a:0]
Höflichkeit [anki:play:q:0]	Die Höflichkeit , Die Höflichkeiten Courtesy [anki:play:a:0]
Wangenknochen [anki:play:q:0]	Die Wangenknochen , Die Wangenknochen Cheekbone [anki:play:a:0]
Peitsche [anki:play:q:0]	Die Peitsche , Die Peitschen Whip [anki:play:a:0]
Pilger [anki:play:q:0]	Der Pilger , Die Pilger Pilgrim [anki:play:a:0]
Kollaps [anki:play:q:0]	Der Kollaps , Die Zusammenbrüche Collapse [anki:play:a:0]
Fakultät [anki:play:q:0]	Die Fakultät , Die Fakultäten Faculty [anki:play:a:0]
Erinnerung [anki:play:q:0]	Die Erinnerung , Die Erinnerungen Reminder [anki:play:a:0]
Weise [anki:play:q:0]	Der Weise , Die Weisen Sage [anki:play:a:0]
Asphalt [anki:play:q:0]	Der Asphalt , Die Asphalte Asphalt [anki:play:a:0]
Privileg [anki:play:q:0]	Das Privileg , Die Privilegien Privilege [anki:play:a:0]
Wartung [anki:play:q:0]	Die Wartung , Die Wartungen Maintenance [anki:play:a:0]
Süße [anki:play:q:0]	Die Süße , Die Süßigkeiten Sweetie [anki:play:a:0]
Obstgarten [anki:play:q:0]	Der Obstgarten , Die Obstgärten Orchard [anki:play:a:0]
Kinderbett [anki:play:q:0]	Das Kinderbett , Die Kinderbetten Cot [anki:play:a:0]
Beutel [anki:play:q:0]	Der Beutel , Die Beutel Pouch [anki:play:a:0]
Feuerzeug [anki:play:q:0]	Das Feuerzeug , Die Feuerzeuge Lighter [anki:play:a:0]
Formation [anki:play:q:0]	Die Formation , Die Formationen Formation [anki:play:a:0]
Snack [anki:play:q:0]	Die Snack , Die Snacks Snack [anki:play:a:0]
Reden [anki:play:q:0]	Das Reden , Die Gesprächen Talking [anki:play:a:0]
Op [anki:play:q:0]	Die Op , Die Ops Op [anki:play:a:0]
Skulptur [anki:play:q:0]	Die Skulptur , Die Skulpturen Sculpture [anki:play:a:0]
Vorsitzende [anki:play:q:0]	Der Vorsitzende , Die Chair Chairman [anki:play:a:0]
Karotte [anki:play:q:0]	Die Karotte , Die Karotten Carrot [anki:play:a:0]
Welligkeit [anki:play:q:0]	Die Welligkeit , Die Wellen Ripple [anki:play:a:0]
Radar [anki:play:q:0]	Die Radar , Die Radare Radar [anki:play:a:0]
Pferdeschwanz [anki:play:q:0]	Der Pferdeschwanz , Die Pferdeschwänze Ponytail [anki:play:a:0]
Designer [anki:play:q:0]	Der Designer , Die Designer Designer [anki:play:a:0]
Erbe [anki:play:q:0]	Der Erbe , Die Erben Heir [anki:play:a:0]
Bunker [anki:play:q:0]	Der Bunker , Die Gewölbe Vault [anki:play:a:0]
Sissy [anki:play:q:0]	Die Sissy , Die Weicheier Sissy [anki:play:a:0]
Schotten [anki:play:q:0]	Die Schotten , Die Bremsschuhe Scotch [anki:play:a:0]
Think [anki:play:q:0]	Der Think , Das Denkt Think [anki:play:a:0]
Penis [anki:play:q:0]	Der Penis , Die Penisse Penis [anki:play:a:0]
Einheimische [anki:play:q:0]	Der Einheimische , Die Eingeborenen Native [anki:play:a:0]
Adjutant [anki:play:q:0]	Der Adjutant , Die Helfer Aide [anki:play:a:0]
Großteil [anki:play:q:0]	Der Großteil , Die Massen Bulk [anki:play:a:0]
Poker [anki:play:q:0]	Die Poker , Die Poker Poker [anki:play:a:0]
Kalk [anki:play:q:0]	Der Kalk , Der Limes Lime [anki:play:a:0]
Überwachungs [anki:play:q:0]	Das Überwachungs , Die Anwendungsbeobachtungen Surveillance [anki:play:a:0]
Chopper [anki:play:q:0]	Der Chopper , Die Zerhacker Chopper [anki:play:a:0]
Träger [anki:play:q:0]	Der Träger , Die Träger Carrier [anki:play:a:0]
Verlobung [anki:play:q:0]	Die Verlobung , Die Engagements Engagement [anki:play:a:0]
Kin [anki:play:q:0]	Das Kin , Die Kins Kin [anki:play:a:0]
Beleuchtung [anki:play:q:0]	Die Beleuchtung , Die Beleuchtung Lighting [anki:play:a:0]
Passform [anki:play:q:0]	Die Passform , Die Anfälle Fit [anki:play:a:0]
Pull [anki:play:q:0]	Die Pull , Die Zieht Pull [anki:play:a:0]
Bauernhaus [anki:play:q:0]	Das Bauernhaus , Die Bauernhäuser Farmhouse [anki:play:a:0]
Attentäter [anki:play:q:0]	Der Attentäter , Die Attentäter Assassin [anki:play:a:0]
Schaum [anki:play:q:0]	Der Schaum , Die Schäume Foam [anki:play:a:0]
Schlepper [anki:play:q:0]	Der Schlepper , Die Schlepper Tug [anki:play:a:0]
Journalist [anki:play:q:0]	Der Journalist , Die Journalisten Journalist [anki:play:a:0]
Aufnahme [anki:play:q:0]	Die Aufnahme , Die Aufnahmen Recording [anki:play:a:0]
Heilung [anki:play:q:0]	Die Heilung , Die Heilungen Cure [anki:play:a:0]
Abstieg [anki:play:q:0]	Der Abstieg , Die Abfahrten Descent [anki:play:a:0]
Klingeln [anki:play:q:0]	Das Klingeln , Die Ringings Ringing [anki:play:a:0]
Schere [anki:play:q:0]	Die Schere , Die Scissorses Scissors [anki:play:a:0]
Zweig [anki:play:q:0]	Der Zweig , Die Zweige Twig [anki:play:a:0]
Beschützer [anki:play:q:0]	Der Beschützer , Die Wächter Guardian [anki:play:a:0]
Gegner [anki:play:q:0]	Der Gegner , Die Gegner Opponent [anki:play:a:0]
Küchenchef [anki:play:q:0]	Der Küchenchef , Die Köche Chef [anki:play:a:0]
Weizen [anki:play:q:0]	Der Weizen , Die Weizen Wheat [anki:play:a:0]
Hurrikan [anki:play:q:0]	Der Hurrikan , Die Hurrikane Hurricane [anki:play:a:0]
Spielplatz [anki:play:q:0]	Der Spielplatz , Die Spielplätze Playground [anki:play:a:0]
Pilz [anki:play:q:0]	Der Pilz , Die Pilze Mushroom [anki:play:a:0]
Tastatur [anki:play:q:0]	Die Tastatur , Die Keyboaries Keyboard [anki:play:a:0]
Zeder [anki:play:q:0]	Die Zeder , Die Zedern Cedar [anki:play:a:0]
Wappen [anki:play:q:0]	Das Wappen , Die Kämme Crest [anki:play:a:0]
Jasmin [anki:play:q:0]	Der Jasmin , Die Jasmin Jasmine [anki:play:a:0]
Sessel [anki:play:q:0]	Der Sessel , Die Sessel Armchair [anki:play:a:0]
Attraktion [anki:play:q:0]	Die Attraktion , Attraktionen Attraction [anki:play:a:0]
Schwalbe [anki:play:q:0]	Die Schwalbe , Die Schwalben Swallow [anki:play:a:0]
Berühmtheit [anki:play:q:0]	Die Berühmtheit , Die Prominenten Celebrity [anki:play:a:0]
Wildnis [anki:play:q:0]	Die Wildnis , Die Wildnis Wilderness [anki:play:a:0]
Dreieck [anki:play:q:0]	Das Dreieck , Die Dreiecke Triangle [anki:play:a:0]
Gestank [anki:play:q:0]	Der Gestank , Die Gestank Stench [anki:play:a:0]
Array [anki:play:q:0]	Das Array , Die Arraies Array [anki:play:a:0]
Valentine [anki:play:q:0]	The Valentine , Die Valentines Valentine [anki:play:a:0]
Renten [anki:play:q:0]	Das Renten , Die Pensionierungen Retirement [anki:play:a:0]
Ski [anki:play:q:0]	Der Ski , Die Skier Ski [anki:play:a:0]
Ausgabe [anki:play:q:0]	Die Ausgabe , Die Ausgaben Edition [anki:play:a:0]
Supervisor [anki:play:q:0]	Der Supervisor , Die Aufsichtsbehörden Supervisor [anki:play:a:0]
Weite [anki:play:q:0]	Die Weite , Die Weiten Expanse [anki:play:a:0]
Moos [anki:play:q:0]	Das Moos , Die Moose Moss [anki:play:a:0]
Sturm [anki:play:q:0]	Der Sturm , Die Stürme Gale [anki:play:a:0]
Treue [anki:play:q:0]	Die Treue , Die Loyalitäten Loyalty [anki:play:a:0]
Lavendel [anki:play:q:0]	Der Lavendel , Die Lavendel Lavender [anki:play:a:0]
Begnadigung [anki:play:q:0]	Die Begnadigung , Die Begnadigungen Pardon [anki:play:a:0]
Aschenbecher [anki:play:q:0]	Der Aschenbecher , Die Aschenbecher Ashtray [anki:play:a:0]
Scherbe [anki:play:q:0]	Die Scherbe , Die Scherben Shard [anki:play:a:0]
Ablenkung [anki:play:q:0]	Die Ablenkung , Die Ablenkungen Distraction [anki:play:a:0]
Majestät [anki:play:q:0]	Die Majestät , Die Majestäten Majesty [anki:play:a:0]
Pyramide [anki:play:q:0]	Die Pyramide , Die Pyramiden Pyramid [anki:play:a:0]
Ruhm [anki:play:q:0]	Der Ruhm , Die Fames Fame [anki:play:a:0]
Schulabschluss [anki:play:q:0]	Der Schulabschluss , Die Schulabschlüsse Graduation [anki:play:a:0]
Not [anki:play:q:0]	Die Not , Die Nöte Distress [anki:play:a:0]
Unabhängigkeit [anki:play:q:0]	Die Unabhängigkeit , Die Unabhängigkeiten Independence [anki:play:a:0]
Schwarm [anki:play:q:0]	Der Schwarm , Die Zermalmt Crush [anki:play:a:0]
Dime [anki:play:q:0]	Die Dime , Die Dimes Dime [anki:play:a:0]
Böen [anki:play:q:0]	Die Böen , Die Böen Gust [anki:play:a:0]
Russe [anki:play:q:0]	Der Russe , Die Russen Russian [anki:play:a:0]
Festlichkeit [anki:play:q:0]	Der Festlichkeit , Die Leckereien Treat [anki:play:a:0]
Ausländer [anki:play:q:0]	Der Ausländer , Die Ausländer Foreigner [anki:play:a:0]
Gehalt [anki:play:q:0]	Das Gehalt , Die Gehälter Salary [anki:play:a:0]
Rebell [anki:play:q:0]	Der Rebell , Die Rebellen Rebel [anki:play:a:0]
Schläger [anki:play:q:0]	Der Schläger , Die Schläger Thug [anki:play:a:0]
Steckdose [anki:play:q:0]	Die Steckdose , Die Buchsen Socket [anki:play:a:0]
Dosis [anki:play:q:0]	Die Dosis , Die Dosen Dose [anki:play:a:0]
Flüchtling [anki:play:q:0]	Der Flüchtling , Die Flüchtlinge Refugee [anki:play:a:0]
Phase [anki:play:q:0]	Die Phase , Die Phasen Phase [anki:play:a:0]
Kürbis [anki:play:q:0]	Der Kürbis , Die Kürbisse Pumpkin [anki:play:a:0]
Dorn [anki:play:q:0]	Der Dorn , Die Dornen Thorn [anki:play:a:0]
Wurst [anki:play:q:0]	Die Wurst , Die Würste Sausage [anki:play:a:0]
Tan [anki:play:q:0]	Der Tan , Die Bräunt Tan [anki:play:a:0]
Darlehen [anki:play:q:0]	Das Darlehen , Die Kredite Loan [anki:play:a:0]
Krume [anki:play:q:0]	Die Krume , Die Krümel Crumb [anki:play:a:0]
Wachs [anki:play:q:0]	Das Wachs , Waxs Wax [anki:play:a:0]
Knurren [anki:play:q:0]	Das Knurren , Die Growls Growl [anki:play:a:0]
Vermietung [anki:play:q:0]	Die Vermietung , Vermietungen Rental [anki:play:a:0]
Futter [anki:play:q:0]	Das Futter , Die Zuführungen Feed [anki:play:a:0]
Erstaunen [anki:play:q:0]	Das Erstaunen , Die Erstaunlichkeiten Astonishment [anki:play:a:0]
Flora [anki:play:q:0]	Die Flora , Die Floren Flora [anki:play:a:0]
Fest [anki:play:q:0]	Das Fest , Die Feste Festival [anki:play:a:0]
Debatte [anki:play:q:0]	Die Debatte , Die Debatten Debate [anki:play:a:0]
Kritiker [anki:play:q:0]	Der Kritiker , Die Kritiker Critic [anki:play:a:0]
Besetzung [anki:play:q:0]	Die Besetzung , Die Modelle Cast [anki:play:a:0]
Loft [anki:play:q:0]	Das Loft , Die Dachböden Loft [anki:play:a:0]
Kommission [anki:play:q:0]	Die Kommission , Die Kommissionen Commission [anki:play:a:0]
Flimmern [anki:play:q:0]	Das Flimmern , Die Flackert Flicker [anki:play:a:0]
Wirtschaft [anki:play:q:0]	Die Wirtschaft , Die Volkswirtschaften Economy [anki:play:a:0]
Strahlung [anki:play:q:0]	Die Strahlung , Die Strahlungen Radiation [anki:play:a:0]
Leibwächter [anki:play:q:0]	Der Leibwächter , Die Bodyguaries Bodyguard [anki:play:a:0]
Umsetzung [anki:play:q:0]	Die Umsetzung , Die Erkenntnisse Realization [anki:play:a:0]
Krater [anki:play:q:0]	Der Krater , Die Krater Crater [anki:play:a:0]
Kongress [anki:play:q:0]	Das Kongress , Die Kongresse Congress [anki:play:a:0]
Braten [anki:play:q:0]	Der Braten , Die Pommes Fry [anki:play:a:0]
Zittern [anki:play:q:0]	Das Zittern , Gänsehaut Shiver [anki:play:a:0]
Verpflichtung [anki:play:q:0]	Die Verpflichtung , Verpflichtungen Obligation [anki:play:a:0]
Verlierer [anki:play:q:0]	Der Verlierer , Die Verlierer Loser [anki:play:a:0]
Zuzwinkern [anki:play:q:0]	Die Zuzwinkern , Die Zwinkert Wink [anki:play:a:0]
Notwendigkeit [anki:play:q:0]	Die Notwendigkeit , Die Notwendigkeiten Necessity [anki:play:a:0]
Workshop [anki:play:q:0]	Der Workshop , Die Workshops Workshop [anki:play:a:0]
Sonnenaufgang [anki:play:q:0]	Der Sonnenaufgang , Die Sonnenaufgang Sunrise [anki:play:a:0]
Erschöpfung [anki:play:q:0]	Die Erschöpfung , Die Erschöpfungs Exhaustion [anki:play:a:0]
Doppelgänger [anki:play:q:0]	Der Doppelgänger , Die Doppelgänger Double [anki:play:a:0]
Umfang [anki:play:q:0]	Der Umfang , Die Umfänge Perimeter [anki:play:a:0]
Kamm [anki:play:q:0]	Der Kamm , Die Kämme Comb [anki:play:a:0]
Kauf [anki:play:q:0]	Der Kauf , Die Käufe Purchase [anki:play:a:0]
Intervall [anki:play:q:0]	Das Intervall , Die Intervalle Interval [anki:play:a:0]
Spritz [anki:play:q:0]	Der Spritz , Die Spritzer Splash [anki:play:a:0]
Konvention [anki:play:q:0]	Die Konvention , Die Konventionen Convention [anki:play:a:0]
Pose [anki:play:q:0]	Die Pose , Die Posen Pose [anki:play:a:0]
Wiege [anki:play:q:0]	Die Wiege , Die Wiegen Cradle [anki:play:a:0]
Stößel [anki:play:q:0]	Der Stößel , Die Widder Ram [anki:play:a:0]
Adel [anki:play:q:0]	Der Adel , Die Gentries Gentry [anki:play:a:0]
Naht [anki:play:q:0]	Die Naht , Die Nähte Seam [anki:play:a:0]
Assoziierte [anki:play:q:0]	Das Assoziierte Unternehmen , Die Mitarbeiter Associate [anki:play:a:0]
Punk [anki:play:q:0]	Der Punk , Die Punks Punk [anki:play:a:0]
Überrest [anki:play:q:0]	Der Überrest , Die Reste Remnant [anki:play:a:0]
Cracker [anki:play:q:0]	Der Cracker , Die Cracker Cracker [anki:play:a:0]
Bluff [anki:play:q:0]	Der Bluff , Die Klippen Bluff [anki:play:a:0]
Düne [anki:play:q:0]	Die Düne , Die Dünen Dune [anki:play:a:0]
Zahnarzt [anki:play:q:0]	Der Zahnarzt , Die Zahnärzte Dentist [anki:play:a:0]
Satin [anki:play:q:0]	Die Satin , Die Satins Satin [anki:play:a:0]
Verbreitung [anki:play:q:0]	Die Verbreitung , Die Spreads Spread [anki:play:a:0]
Postfach [anki:play:q:0]	Das Postfach , Die Mailboxs Mailbox [anki:play:a:0]
Ärger [anki:play:q:0]	Der Ärger , Die Ärgernisse Annoyance [anki:play:a:0]
Zischen [anki:play:q:0]	Das Zischen , Die Zischt Hiss [anki:play:a:0]
Lokal [anki:play:q:0]	Das Lokal , Die Einheimischen Local [anki:play:a:0]
Bums [anki:play:q:0]	Der Bums , Die Schläge Thud [anki:play:a:0]
Bestürzung [anki:play:q:0]	Die Bestürzung , Die Bestürzt Dismay [anki:play:a:0]
Mehl [anki:play:q:0]	Das Mehl , Die Mehle Flour [anki:play:a:0]
Freak [anki:play:q:0]	Der Freak , Die Freaks Freak [anki:play:a:0]
Haarschnitt [anki:play:q:0]	Der Haarschnitt , Die Abschläge Haircut [anki:play:a:0]
Waise [anki:play:q:0]	Die Waise , Die Waisen Orphan [anki:play:a:0]
Schach [anki:play:q:0]	Das Schach , Die Chesses Chess [anki:play:a:0]
Blütenblatt [anki:play:q:0]	Die Blütenblatt , Die Blütenblätter Petal [anki:play:a:0]
Schreibarbeit [anki:play:q:0]	Die Schreibarbeit , Die Papierarbeiten Paperwork [anki:play:a:0]
Psychiater [anki:play:q:0]	Der Psychiater , Die Psychiater Psychiatrist [anki:play:a:0]
Gesang [anki:play:q:0]	Der Gesang , Die Gesänge Singing [anki:play:a:0]
Interrupt [anki:play:q:0]	Das Interrupt , Die Interrupts Interrupt [anki:play:a:0]
Untersuchung [anki:play:q:0]	Die Untersuchung , Untersuchungen Examination [anki:play:a:0]
Bewunderung [anki:play:q:0]	Die Bewunderung , Die Bewunderung Admiration [anki:play:a:0]
Gefrier [anki:play:q:0]	Das Gefrier , Die Gefriergeräte Freezer [anki:play:a:0]
Illustration [anki:play:q:0]	Die Illustration , Abbildungen Illustration [anki:play:a:0]
Eintopf [anki:play:q:0]	Der Eintopf , Die Eintöpfe Stew [anki:play:a:0]
Ermittler [anki:play:q:0]	Der Ermittler , Die Ermittler Investigator [anki:play:a:0]
Holster [anki:play:q:0]	Das Holster , Die Holster Holster [anki:play:a:0]
Faktor [anki:play:q:0]	Der Faktor , Die Faktoren Factor [anki:play:a:0]
Intimität [anki:play:q:0]	Die Intimität , Die Intimitäten Intimacy [anki:play:a:0]
Einsparung [anki:play:q:0]	Die Einsparung , Die Einsparungen Saving [anki:play:a:0]
Software [anki:play:q:0]	Die Software , Die Software Software [anki:play:a:0]
Henne [anki:play:q:0]	Die Henne , Die Hennen Hen [anki:play:a:0]
Birke [anki:play:q:0]	Die Birke , Die Birken Birch [anki:play:a:0]
Ausmaß [anki:play:q:0]	Das Ausmaß , Die Ausdehnungen Extent [anki:play:a:0]
Definition [anki:play:q:0]	Die Definition , Die Definitionen Definition [anki:play:a:0]
Monument [anki:play:q:0]	Das Monument , Die Denkmäler Monument [anki:play:a:0]
Pflaume [anki:play:q:0]	Die Pflaume , Die Pflaumen Plum [anki:play:a:0]
Nichts [anki:play:q:0]	Das Nichts , Die Hohlräume Void [anki:play:a:0]
Verzögerung [anki:play:q:0]	Die Verzögerung , Die Verzögerungen Delay [anki:play:a:0]
Inspektion [anki:play:q:0]	Die Inspektion , Die Inspektionen Inspection [anki:play:a:0]
Essenz [anki:play:q:0]	Die Essenz , Die Essenzen Essence [anki:play:a:0]
Kanone [anki:play:q:0]	Die Kanone , Die Kanonen Cannon [anki:play:a:0]
Fransen [anki:play:q:0]	Die Fransen , Die Fransen Fringe [anki:play:a:0]
Stereo [anki:play:q:0]	Die Stereo , Die Stereoanlagen Stereo [anki:play:a:0]
Fella [anki:play:q:0]	Die Fella , Fellas Fella [anki:play:a:0]
Lob [anki:play:q:0]	Das Lob , Das Lob Praise [anki:play:a:0]
Pinguin [anki:play:q:0]	Der Pinguin , Die Pinguine Penguin [anki:play:a:0]
Briefmarke [anki:play:q:0]	Die Briefmarke , Die Briefmarken Stamp [anki:play:a:0]
Partikel [anki:play:q:0]	Die Partikel , Die Teilchen Particle [anki:play:a:0]
Übersetzer [anki:play:q:0]	Der Übersetzer , Die Übersetzer Translator [anki:play:a:0]
Einfrieren [anki:play:q:0]	Das Einfrieren , Die Friert Freeze [anki:play:a:0]
Pew [anki:play:q:0]	Die Pew , Die Bänke Pew [anki:play:a:0]
Pfropfen [anki:play:q:0]	Der Pfropfen , Die Bündel Wad [anki:play:a:0]
Höschen [anki:play:q:0]	Das Höschen , Die Pantieses Panties [anki:play:a:0]
Gegenleistung [anki:play:q:0]	Die Gegenleistung , Überlegungen Consideration [anki:play:a:0]
Spieß [anki:play:q:0]	Der Spieß , Die Spieße Spit [anki:play:a:0]
Kühler [anki:play:q:0]	Der Kühler , Die Kühler Cooler [anki:play:a:0]
Grill [anki:play:q:0]	Der Grill , Die Grills Grill [anki:play:a:0]
Revolver [anki:play:q:0]	Der Revolver , Die Revolver Revolver [anki:play:a:0]
Maschinen [anki:play:q:0]	Die Maschinen , Die Maschinen Machinery [anki:play:a:0]
Damen [anki:play:q:0]	Die Damen Und Herren , Die Herren Madam [anki:play:a:0]
Hecht [anki:play:q:0]	Der Hecht , Pikes Pike [anki:play:a:0]
Terrorist [anki:play:q:0]	Der Terrorist , Die Terroristen Terrorist [anki:play:a:0]
Laptop [anki:play:q:0]	Der Laptop , Die Laptops Laptop [anki:play:a:0]
Schnabel [anki:play:q:0]	Der Schnabel , Die Schnäbel Beak [anki:play:a:0]
Institution [anki:play:q:0]	Die Institution , Die Institutionen Institution [anki:play:a:0]
Vergleich [anki:play:q:0]	Der Vergleich , die Vergleiche Comparison [anki:play:a:0]
Macher [anki:play:q:0]	Der Macher , Die Macher Maker [anki:play:a:0]
Einsicht [anki:play:q:0]	Die Einsicht , Die Erkenntnisse Insight [anki:play:a:0]
Geschwister [anki:play:q:0]	Die Geschwister , Die Geschwister Sibling [anki:play:a:0]
Kleiderschrank [anki:play:q:0]	Der Kleiderschrank , Die Schränke Wardrobe [anki:play:a:0]
Klappe [anki:play:q:0]	Die Klappe , Die Klappen Flap [anki:play:a:0]
Einzige [anki:play:q:0]	Der Einzige , Die Sohlen Sole [anki:play:a:0]
Ego [anki:play:q:0]	Das Ego , Die Egos Ego [anki:play:a:0]
Antennen [anki:play:q:0]	Die Antennen , Die Antennen Antenna [anki:play:a:0]
Grille [anki:play:q:0]	Die Grille , Die Grillen Cricket [anki:play:a:0]
Troll [anki:play:q:0]	Der Troll , Die Trolle Troll [anki:play:a:0]
Bücherladen [anki:play:q:0]	Der Bücherladen , Die Buchhandlungen Bookstore [anki:play:a:0]
Einwand [anki:play:q:0]	Der Einwand , Die Einwände Objection [anki:play:a:0]
Unwissenheit [anki:play:q:0]	Die Unwissenheit , Die Unwissenheit Ignorance [anki:play:a:0]
Erweiterung [anki:play:q:0]	Die Erweiterung , Die Verlängerungen Extension [anki:play:a:0]
Untertasse [anki:play:q:0]	Die Untertasse , Die Untertassen Saucer [anki:play:a:0]
Dringlichkeit [anki:play:q:0]	Die Dringlichkeit , Die Dringlichkeiten Urgency [anki:play:a:0]
Vulkan [anki:play:q:0]	Der Vulkan , Die Vulkane Volcano [anki:play:a:0]
Würze [anki:play:q:0]	Die Würze , Die Würzen aroma [anki:play:a:0]
Fähre [anki:play:q:0]	Die Fähre , Die Fähren Ferry [anki:play:a:0]
Rezept [anki:play:q:0]	Das Rezept , Die Rezepte Recipe [anki:play:a:0]
Verrat [anki:play:q:0]	Der Verrat , Der Verrat Betrayal [anki:play:a:0]
Gehweg [anki:play:q:0]	Der Gehweg , Die Gehwege Walkway [anki:play:a:0]
Hinken [anki:play:q:0]	Das Hinken , Die Hinkt Limp [anki:play:a:0]
Verwaltung [anki:play:q:0]	Die Verwaltung , Die Verwaltungen Administration [anki:play:a:0]
Bequemlichkeit [anki:play:q:0]	Die Bequemlichkeit , Bequemlichkeiten Convenience [anki:play:a:0]
Klarheit [anki:play:q:0]	Die Klarheit , Die Klarheiten Clarity [anki:play:a:0]
Missbrauch [anki:play:q:0]	Der Missbrauch , Die Missbräuche Abuse [anki:play:a:0]
Ansager [anki:play:q:0]	Der Ansager , Die Ansager Announcer [anki:play:a:0]
Übertragungs [anki:play:q:0]	Die Übertragungs , Die Übertragungen Transmission [anki:play:a:0]
Auditorium [anki:play:q:0]	Das Auditorium , Die Auditorien Auditorium [anki:play:a:0]
Zapfen [anki:play:q:0]	Der Zapfen , Die Zapfen Peg [anki:play:a:0]
Niederlage [anki:play:q:0]	Die Niederlage , Die Niederlagen Defeat [anki:play:a:0]
Probe [anki:play:q:0]	Die Probe , Die Proben Specimen [anki:play:a:0]
Zulassung [anki:play:q:0]	Die Zulassung , Die Zulassungs Admission [anki:play:a:0]
Besessenheit [anki:play:q:0]	Die Besessenheit Obsession [anki:play:a:0]
Wohnheim [anki:play:q:0]	Das Wohnheim , Die Wohnheime Dorm [anki:play:a:0]
Glen [anki:play:q:0]	The Glen , Die Täler Glen [anki:play:a:0]
Säge [anki:play:q:0]	Die Säge , Die Sägen Saw [anki:play:a:0]
Til [anki:play:q:0]	Die Til , Die Tils Til [anki:play:a:0]
Staffelungs [anki:play:q:0]	Der Staffelungs , Die Wankt Stagger [anki:play:a:0]
Fotze [anki:play:q:0]	Die Fotze , Die Fotzen Pussy [anki:play:a:0]
Sammler [anki:play:q:0]	Der Sammler , Die Kollektoren Collector [anki:play:a:0]
Erdbeben [anki:play:q:0]	Das Erdbeben , Die Erdbeben Earthquake [anki:play:a:0]
Flocke [anki:play:q:0]	Die Flocke , Die Flocken Flake [anki:play:a:0]
Silbe [anki:play:q:0]	Die Silbe , Die Silben Syllable [anki:play:a:0]
Bouquet [anki:play:q:0]	Das Bouquet , Die Blumensträuße Bouquet [anki:play:a:0]
Auswahl [anki:play:q:0]	Die Auswahl , Die Selektionen Selection [anki:play:a:0]
Schwur [anki:play:q:0]	Der Schwur , Die Gelübde Vow [anki:play:a:0]
Enkelin [anki:play:q:0]	Die Enkelin , Die Enkel Granddaughter [anki:play:a:0]
Symptom [anki:play:q:0]	Das Symptom , Die Symptome Symptom [anki:play:a:0]
Szenario [anki:play:q:0]	Das Szenario , Die Szenarien Scenario [anki:play:a:0]
Aufruhr [anki:play:q:0]	Der Aufruhr , Die Unruhen Riot [anki:play:a:0]
Burger [anki:play:q:0]	Der Burger , Die Burger Burger [anki:play:a:0]
Spatz [anki:play:q:0]	Der Spatz , Die Spatzen Sparrow [anki:play:a:0]
Botschaft [anki:play:q:0]	Die Botschaft , Die Botschaften Embassy [anki:play:a:0]
Podium [anki:play:q:0]	Das Podium , Die Podestplätze Podium [anki:play:a:0]
Vorwurf [anki:play:q:0]	Der Vorwurf , Die Vorwürfe Accusation [anki:play:a:0]
Herrenhaus [anki:play:q:0]	Das Herrenhaus , Die Herrenhäuser Manor [anki:play:a:0]
Schlurfen [anki:play:q:0]	Das Schlurfen , Die Shufflings Shuffling [anki:play:a:0]
Delfin [anki:play:q:0]	Der Delfin , Die Delphine Dolphin [anki:play:a:0]
Wasserkocher [anki:play:q:0]	Der Wasserkocher , Die Kessel Kettle [anki:play:a:0]
Tierarzt [anki:play:q:0]	Der Tierarzt , Die Tierärzte Vet [anki:play:a:0]
Mohn [anki:play:q:0]	Der Mohn , Der Mohn Poppy [anki:play:a:0]
Lava [anki:play:q:0]	Die Lava , Die Laven Lava [anki:play:a:0]
Inspiration [anki:play:q:0]	Die Inspiration , Die Inspirationen Inspiration [anki:play:a:0]
Busen [anki:play:q:0]	Der Busen , Die Busen Bosom [anki:play:a:0]
Eindringling [anki:play:q:0]	Der Eindringling , Die Eindringlinge Intruder [anki:play:a:0]
Supermarkt [anki:play:q:0]	Der Supermarkt , Die Supermärkte Supermarket [anki:play:a:0]
Pokal [anki:play:q:0]	Der Pokal , Die Trophäen Trophy [anki:play:a:0]
Eifersucht [anki:play:q:0]	Die Eifersucht , Die Eifersucht Jealousy [anki:play:a:0]
Aufseher [anki:play:q:0]	Der Aufseher , Des Direktors Warden [anki:play:a:0]
Yachthafen [anki:play:q:0]	Der Yachthafen , Die Jachthäfen Marina [anki:play:a:0]
Lebewohl [anki:play:q:0]	Das Lebewohl , Die Abschiede Farewell [anki:play:a:0]
Erholung [anki:play:q:0]	Die Erholung Recovery [anki:play:a:0]
Kabelbaum [anki:play:q:0]	Der Kabelbaum , Die Kabelbäume Harness [anki:play:a:0]
Logo [anki:play:q:0]	Das Logo , Die Logos Logo [anki:play:a:0]
Wurf [anki:play:q:0]	Der Wurf , Die Würfe Litter [anki:play:a:0]
Groll [anki:play:q:0]	Der Groll Resentment [anki:play:a:0]
Zigeuner [anki:play:q:0]	Der Zigeuner , Die Zigeuner Gypsy [anki:play:a:0]
Nachahmung [anki:play:q:0]	Die Nachahmung , Die Nachahmungen Imitation [anki:play:a:0]
Arbeitgeber [anki:play:q:0]	Der Arbeitgeber , Arbeitgeber Employer [anki:play:a:0]
Neuling [anki:play:q:0]	Der Neuling , Die Neulinge Freshman [anki:play:a:0]
Phänomen [anki:play:q:0]	Das Phänomen , Die Phänomene Phenomenon [anki:play:a:0]
Flöte [anki:play:q:0]	Die Flöte , Die Flöten Flute [anki:play:a:0]
Grieche [anki:play:q:0]	Der Grieche , Die Griechen Greek [anki:play:a:0]
Zeigefinger [anki:play:q:0]	Der Zeigefinger , Die Zeigefingern Forefinger [anki:play:a:0]
Republik [anki:play:q:0]	Die Republik , Die Republiken Republic [anki:play:a:0]
Smaragd [anki:play:q:0]	Der Smaragd , Die Smaragde Emerald [anki:play:a:0]
Bademantel [anki:play:q:0]	Der Bademantel , Die Bademäntel Bathrobe [anki:play:a:0]
Zeugnis [anki:play:q:0]	Das Zeugnis , Die Zeugenaussagen Testimony [anki:play:a:0]
Scharnier [anki:play:q:0]	Das Scharnier , Die Scharniere Hinge [anki:play:a:0]
Bäckerei [anki:play:q:0]	Die Bäckerei , Die Bäckereien Bakery [anki:play:a:0]
Kontext [anki:play:q:0]	Der Kontext , Die Kontexte Context [anki:play:a:0]
Schnäppchen [anki:play:q:0]	Das Schnäppchen , Die Schnäppchen Bargain [anki:play:a:0]
Vorarbeiter [anki:play:q:0]	Der Vorarbeiter , Die Foremans Foreman [anki:play:a:0]
Schwan [anki:play:q:0]	Der Schwan , Die Schwäne Swan [anki:play:a:0]
Flanell [anki:play:q:0]	Die Flanell , Die Waschlappen Flannel [anki:play:a:0]
Angabe [anki:play:q:0]	Die Angabe , Die Angaben Indication [anki:play:a:0]
Fraktion [anki:play:q:0]	Die Fraktion , Die Fraktionen Fraction [anki:play:a:0]
Forelle [anki:play:q:0]	Die Forelle , Die Forellen Trout [anki:play:a:0]
Kruste [anki:play:q:0]	Die Kruste , Die Krusten Crust [anki:play:a:0]
Überzug [anki:play:q:0]	Der Überzug , Die Überzugs Overcoat [anki:play:a:0]
Glitzern [anki:play:q:0]	Das Glitzern o brilho [anki:play:a:0]
Medaille [anki:play:q:0]	Die Medaille , Die Medaillen Medal [anki:play:a:0]
Wahrnehmung [anki:play:q:0]	Die Wahrnehmung , Die Wahrnehmungen Perception [anki:play:a:0]
Willkommen [anki:play:q:0]	Das Willkommen , Die Willkommen Welcome [anki:play:a:0]
Wörterbuch [anki:play:q:0]	Das Wörterbuch , Die Wörterbücher Dictionary [anki:play:a:0]
Metapher [anki:play:q:0]	Die Metapher , Die Metaphern Metaphor [anki:play:a:0]
Armut [anki:play:q:0]	Die Armut Poverty [anki:play:a:0]
Haupt [anki:play:q:0]	Das Haupt , die Häupter Main [anki:play:a:0]
Anstieg [anki:play:q:0]	Der Anstieg , Die Anstiege Aumento, the increase [anki:play:a:0]
Leine [anki:play:q:0]	Die Leine , Die Leinen Leash [anki:play:a:0]
Ernährung [anki:play:q:0]	die Ernährung, die Ernährungen alimentação [anki:play:a:0]
Fakt [anki:play:q:0]	der Fakt, Die Fakten fatos [anki:play:a:0]
Laden [anki:play:q:0]	der Laden, die Läden Loja [anki:play:a:0]
Praktikum [anki:play:q:0]	das Praktikum, die Praktika estágio [anki:play:a:0]
Abstand [anki:play:q:0]	der Abstand, die Abstände distância, espaço [anki:play:a:0]
Auftrag [anki:play:q:0]	der Auftrag, Die Aufträge missão, ordem, contrato [anki:play:a:0]
Reiher [anki:play:q:0]	der Reiher, die Reiher a garça [anki:play:a:0]
Schatzung [anki:play:q:0]	die Schatzung, die Schatzungen a estmativa [anki:play:a:0]
Nachdruck [anki:play:q:0]	der Nachdruck, die Nachdrücke a ênfase [anki:play:a:0]
Zuneigung [anki:play:q:0]	die Zuneigung, die Zuneigungen o afeto [anki:play:a:0]
Bericht [anki:play:q:0]	der Bericht, die Berichte report, relatório [anki:play:a:0]
Kenntnis [anki:play:q:0]	die Kenntnis, die Kenntnisse knowledge [anki:play:a:0]
Abnahme [anki:play:q:0]	die Abnahme,die Abnahmen diminuição [anki:play:a:0]
Anteil [anki:play:q:0]	der Anteil, die Anteile Proporção [anki:play:a:0]
Zustand [anki:play:q:0]	der Zustand, die Zustände condição, condition [anki:play:a:0]
Zutat [anki:play:q:0]	die Zutat, die Zutaten ingrediente [anki:play:a:0]
Anstrengung [anki:play:q:0]	die Anstrengung, die Anstrengungen esforço, empenho [anki:play:a:0]
Bemühung [anki:play:q:0]	die Bemühung, die Bemühungen esforço, empenho [anki:play:a:0]
Beschränkung [anki:play:q:0]	die Beschränkung, die Beschränkungen a limitação [anki:play:a:0]
Benehmen [anki:play:q:0]	das Benehmen, --- o comportamento Não existe plural [anki:play:a:0]
Unterkommen [anki:play:q:0]	das Unterkommen, die Unterkommen accomodation [anki:play:a:0]
Unterkunft [anki:play:q:0]	die Unterkunft, die Unterkünfte hospedagem [anki:play:a:0]
Schwindelanfall [anki:play:q:0]	der Schwindelanfall, die Schwindelanfälle tontura [anki:play:a:0]
Verwandlung [anki:play:q:0]	die Verwandlung, die Verwandlungen a metamorfose [anki:play:a:0]
Mühe [anki:play:q:0]	die Mühe, die Mühen trabalho [anki:play:a:0]
